Item,Description,UOM,Available,OnHand,Allocated,OnOrder,WHS,Cost
2201,Amberjack (Yellowtail)  11 lbs,LBS,649,748,99,0,1,133.32
2201,Amberjack (Yellowtail)  11 lbs,LBS,0,0,0,0,5,133.32
2203,Tuna-AA  11#/BX,CS,0,0,0,0,1,93.75
2203,Tuna-AA  11#/BX,CS,0,0,0,0,5,93.75
2204,Tuna-A   (22),LBS,6402,12430,6028,6600,1,167.20
2204,Tuna-A   (22),LBS,0,0,0,0,5,167.20
2207,Albacore 22lbs.,CS,0,0,0,0,1,181.50
2207,Albacore 22lbs.,CS,0,0,0,0,5,181.50
2209,Tuna C-Tatakimi 22lbs,LBS,4026,11220,7194,0,1,147.40
2209,Tuna C-Tatakimi 22lbs,LBS,0,0,0,0,5,147.40
2210,MSC Tuna A,LBS,6798,10450,3652,4400,1,187.00
2211,MSC Albacore 22,CS,41,91,50,0,1,181.50
2212,Tuna w/ skin,LBS,0,0,0,0,1,174.90
2212,Tuna w/ skin,LBS,0,0,0,0,5,174.90
2216,Tuna Tray,TRAY,665,805,140,0,1,226.80
2216,Tuna Tray,TRAY,0,0,0,0,5,226.80
2232,Smoked Atlantic  Salmon   (24),LBS,216,648,432,0,1,248.40
2232,Smoked Atlantic  Salmon   (24),LBS,0,0,0,0,5,248.40
2236,Atlantic Salmon 22,LBS,0,0,0,0,1,145.20
2236,Atlantic Salmon 22,LBS,0,0,0,0,5,145.20
2237,ASC Atlantic Salmon,LBS,25586,44682,19096,22000,1,145.20
2238,Pre Cut Atlantic Salmon 10/CS,LBS,0,0,0,0,1,71.00
2240,Salmon with Skin,LBS,-132,0,132,0,1,135.30
2240,Salmon with Skin,LBS,0,0,0,0,5,135.30
2244,Salmon.Grilled  Coho Roast Fzn. 22/CS,CS,99,168,69,0,1,199.82
2244,Salmon.Grilled  Coho Roast Fzn. 22/CS,CS,2050,2050,0,0,5,199.82
2252,Fresh Water Eel   (11),LBS,462,583,121,0,1,183.37
2252,Fresh Water Eel   (11),LBS,3212,3212,0,0,5,183.37
2259,Unakaba. Imitation Eel 4/24/CS,PK,1248,2400,1152,0,1,18.72
2259,Unakaba. Imitation Eel 4/24/CS,PK,69504,69504,0,0,5,18.72
2406,Shrimp Tray Vannamei 20tray/CS,TRAY,2920,5960,3040,0,1,108.40
2406,Shrimp Tray Vannamei 20tray/CS,TRAY,52640,52640,0,0,5,108.40
2418,Tempura Shrimp 10Pc 15tray/CS,TRAY,12840,18405,5565,22680,1,49.05
2418,Tempura Shrimp 10Pc 15tray/CS,TRAY,4455,4455,0,0,5,49.05
2436,Baby Shrimp 5 lbs 4bag/CS,BAG,0,856,856,720,1,112.00
2436,Baby Shrimp 5 lbs 4bag/CS,BAG,0,0,0,0,5,112.00
2440,Crab Stick Imi  H.G. CS16,PK,2464,16416,13952,0,1,65.92
2440,Crab Stick Imi  H.G. CS16,PK,123312,123312,0,0,5,65.92
2441,Crab Flake Imi  H.G.CS16,PK,0,0,0,0,1,61.44
2441,Crab Flake Imi  H.G.CS16,PK,0,0,0,0,5,61.44
2442,AFC Crab Shredded CS16,PK,688,13552,12864,0,1,63.20
2442,AFC Crab Shredded CS16,PK,61040,61040,0,0,5,63.20
2443,Crab Stick India CS16,PACK,0,0,0,0,1,62.72
2443,Crab Stick India CS16,PACK,0,0,0,0,5,62.72
2444,Natural Imitation Crab Stick,CS,41,41,0,0,1,61.77
2451,Imi Crab Flake Kosher,CS,0,0,0,0,1,55.00
2451,Imi Crab Flake Kosher,CS,0,0,0,0,5,55.00
2466,Real Crab   (5) 25lb/CS,lb,3575,3825,250,0,1,206.25
2466,Real Crab   (5) 25lb/CS,lb,0,0,0,0,5,206.25
2472,Kosh Imit Crab Stick 12/1lbs,CS,0,13,13,0,1,65.00
2472,Kosh Imit Crab Stick 12/1lbs,CS,0,0,0,0,5,65.00
2605,Fried Tofu Cubes 10 x 2.2lbs,CASE,112,123,11,0,1,62.50
2605,Fried Tofu Cubes 10 x 2.2lbs,CASE,0,0,0,0,5,62.50
2606,Natural Tempura Crispy 6bag/CS,BAG,3042,3510,468,0,1,43.50
2606,Natural Tempura Crispy 6bag/CS,BAG,0,0,0,0,5,43.50
2619,Fish Roe Masago 4.4 lbs  4/CS,PK,108,168,60,0,1,126.00
2619,Fish Roe Masago 4.4 lbs  4/CS,PK,1920,1920,0,0,5,126.00
2625,Fish Roe Masago 0.44 lbs. 30pk/cs,PK,1590,2460,870,0,1,84.00
2625,Fish Roe Masago 0.44 lbs. 30pk/cs,PK,3000,3000,0,0,5,84.00
2630,Tobiko Red  12/1.1 lbs/CS,PK,252,456,204,0,1,150.00
2630,Tobiko Red  12/1.1 lbs/CS,PK,0,0,0,0,5,150.00
2642,Mushroom  1.1 lbs 10/CS,PK,0,0,0,0,1,45.00
2642,Mushroom  1.1 lbs 10/CS,PK,0,0,0,0,5,45.00
2648,Gourd 2.2LB 10/CS,PK,-20,0,20,0,1,90.00
2648,Gourd 2.2LB 10/CS,PK,0,0,0,0,5,90.00
2654,Carrot 2.2 lbs 6/CS,PK,0,0,0,0,1,21.00
2654,Carrot 2.2 lbs 6/CS,PK,0,0,0,0,5,21.00
2660,Edamame Beans 10/2lbs,BAG,280,630,350,0,1,31.30
2660,Edamame Beans 10/2lbs,BAG,9810,9810,0,0,5,31.30
2666,Egg Cake 20/CS,EACH,-20,0,20,0,1,18.75
2666,Egg Cake 20/CS,EACH,0,0,0,0,5,18.75
2672,Seabreeze Salad  24/1.1  LBS/CS,EACH,1800,5184,3384,0,1,90.48
2672,Seabreeze Salad  24/1.1  LBS/CS,EACH,12168,12168,0,0,5,90.48
2678,Calamari Salad  24/1.1 lbs/CS,EACH,1104,2880,1776,0,1,120.96
2678,Calamari Salad  24/1.1 lbs/CS,EACH,0,0,0,0,5,120.96
2682,AFC Fusion Spicy Sauce,CASE,0,0,0,0,1,45.20
2682,AFC Fusion Spicy Sauce,CASE,0,0,0,0,5,45.20
27,PALLET,EACH,0,0,0,0,1,7.50
27,PALLET,EACH,0,0,0,0,5,7.50
2805,Grilled Chicken 2/5lb/CS,BAG,266,334,68,320,1,32.00
2805,Grilled Chicken 2/5lb/CS,BAG,0,0,0,0,5,32.00
2810,Grilled Dumpling Shrimp 30/CS,BAG,2580,10770,8190,0,1,117.00
2810,Grilled Dumpling Shrimp 30/CS,BAG,79500,79500,0,0,5,117.00
2817,Chicken Gyoza Mushroom (ORANGE) 10/49pc,CS,0,0,0,0,1,46.80
2817,Chicken Gyoza Mushroom (ORANGE) 10/49pc,CS,0,0,0,0,5,46.80
2818,Chicken Gyoza  Leek (WHITE) 10/49pc,CS,0,0,0,0,1,46.80
2818,Chicken Gyoza  Leek (WHITE) 10/49pc,CS,0,0,0,0,5,46.80
2819,Pre Fried Spring Roll 200pc/CS,CS,245,476,231,0,1,45.00
2819,Pre Fried Spring Roll 200pc/CS,CS,0,0,0,0,5,45.00
2820,Shumai 104P/CS,CS,0,0,0,0,1,25.85
2820,Shumai 104P/CS,CS,0,0,0,0,5,25.85
2821,Pork Shumai 108pc/CS,CS,870,1168,298,0,1,26.20
2822,AFC Sukiyaki Beef 12/1lbs,CS,192,195,3,0,1,55.20
2822,AFC Sukiyaki Beef 12/1lbs,CS,0,0,0,0,5,55.20
2824,Chicken Katsu 30lb/CS,CS,40,40,0,0,1,101.40
2824,Chicken Katsu 30lb/CS,CS,630,630,0,0,5,101.40
2826,Asian BBQ Beef 30#,CS,35,63,28,0,1,131.70
2826,Asian BBQ Beef 30#,CS,634,634,0,515,5,131.70
2827,Yakiniku  Beef  10/2.2lb,CS,0,0,0,0,1,73.20
2827,Yakiniku  Beef  10/2.2lb,CS,0,0,0,0,5,73.20
2828,Diced Pastrami  4BAG/CS,BAG,0,0,0,0,1,65.52
2828,Diced Pastrami  4BAG/CS,BAG,0,0,0,0,5,65.52
2829,Japanese Meatball 10pk/cs,CS,277,277,0,0,1,63.80
2831,Crispy Chicken (Karaage) 30#/CS,CS,5,172,167,0,1,67.20
2831,Crispy Chicken (Karaage) 30#/CS,CS,1890,1890,0,1176,5,67.20
2835,#3 Teriyaki Chicken 5x5.28 lbs bag,BAG,0,0,0,0,1,80.50
2835,#3 Teriyaki Chicken 5x5.28 lbs bag,BAG,0,0,0,0,5,80.50
2836,#3 Teriyaki Chicken OH,CS,0,254,254,0,1,107.10
2836,#3 Teriyaki Chicken OH,CS,880,880,0,1680,5,107.10
2837,Chicken Skewers (Yakitori) 20bags/cs,CS,145,321,176,0,1,86.00
2840,#6 Chicken Breast 10 lbs/CS,CS,116,116,0,0,1,42.75
2840,#6 Chicken Breast 10 lbs/CS,CS,0,0,0,0,5,42.75
2843,Pork Chashu  8LBS/CS,CS,21,28,7,0,1,74.27
2843,Pork Chashu  8LBS/CS,CS,0,0,0,0,5,74.27
2845,UDON. SANUKI 8/2.75lbs,CS,27,27,0,0,1,20.80
2845,UDON. SANUKI 8/2.75lbs,CS,0,0,0,0,5,20.80
2846,Chicken Chashu w/Soy 20/1lbs,CASE,0,0,0,0,1,89.87
2846,Chicken Chashu w/Soy 20/1lbs,CASE,0,0,0,0,5,89.87
2847,AFC Tonkotsu Ramen  w/Vegetables  50pc/6oz,CASE,0,0,0,0,1,115.00
2847,AFC Tonkotsu Ramen  w/Vegetables  50pc/6oz,CASE,0,0,0,0,5,115.00
2855,Yakisoba. JSL  Fzn Noodles 5/4lbs,CS,172,198,26,0,1,18.67
2855,Yakisoba. JSL  Fzn Noodles 5/4lbs,CS,0,0,0,0,5,18.67
2861,Fzn Ramen Noodles. MTC 40pc,CS,100,140,40,0,1,27.20
2861,Fzn Ramen Noodles. MTC 40pc,CS,0,0,0,0,5,27.20
2862,Ramen Yamachan 40pc/cs,CS,0,0,0,0,1,20.80
2865,INARI PACK 30 pc 20/CS,PACK,1780,2840,1060,0,1,56.20
2865,INARI PACK 30 pc 20/CS,PACK,9340,9340,0,0,5,56.20
2870,Natural Inari 10/60pc,PK,0,0,0,0,1,55.30
2870,Natural Inari 10/60pc,PK,0,0,0,0,5,55.30
2875,Classic Yummy Sauce 4/Gal/CS,BOT,0,0,0,0,1,86.52
2875,Classic Yummy Sauce 4/Gal/CS,BOT,0,0,0,0,5,86.52
2876,Yuzu Sauce 10/per Cs,BOT,0,0,0,0,1,200.00
2877,Vegetable Curry CS50,CS,15,15,0,0,1,46.19
2877,Vegetable Curry CS50,CS,300,300,0,0,5,46.19
2885,Fzn AFC Goma Sesame Dressing 12/kg Otafu,PK,0,0,0,0,1,42.00
2885,Fzn AFC Goma Sesame Dressing 12/kg Otafu,PK,0,0,0,0,5,42.00
2999,Waygu,CS,98,98,0,0,1,102.96
3205,Ginger A 20LB,EACH,93,156,63,0,1,29.00
3205,Ginger A 20LB,EACH,0,0,0,0,5,29.00
3210,Ginger B 20LB,EACH,217,569,352,0,1,30.00
3210,Ginger B 20LB,EACH,0,0,0,0,5,30.00
3215,Wasabi 2.2lb,PK,203,2470,2267,0,1,3.94
3215,Wasabi 2.2lb,PK,0,0,0,0,5,3.94
3220,Seaweed Nori 200 1/2SH,BAG,25405,31145,5740,0,1,310.80
3220,Seaweed Nori 200 1/2SH,BAG,0,0,0,0,5,310.80
3235,Soy Sauce L/S 1000 pc,CS,2278,3368,1090,0,1,15.02
3235,Soy Sauce L/S 1000 pc,CS,0,0,0,0,5,15.02
3236,Wild Blue Soy Sauce L/S 1000pc,CS,110,111,1,0,1,19.89
3240,Soy Sauce Special IZU,CS,0,0,0,0,1,15.40
3240,Soy Sauce Special IZU,CS,0,0,0,0,5,15.40
3245,PREMIUM RICE 40 lbs,BAG,5519,6601,1082,1050,1,16.00
3245,PREMIUM RICE 40 lbs,BAG,0,0,0,0,5,16.00
3246,AFC Brown Rice  40#,BAG,729,872,143,1050,1,16.52
3253,SPECIAL Military Brown Rice,BAG,54,66,12,0,1,30.05
3253,SPECIAL Military Brown Rice,BAG,0,0,0,0,5,30.05
3256,Vinegar  H-100 Natural 5.28gal,CS,3008,3830,822,0,1,26.02
3256,Vinegar  H-100 Natural 5.28gal,CS,0,0,0,0,5,26.02
3265,Sesame Seeds 5LB,BAG,2377,2581,204,0,1,10.55
3265,Sesame Seeds 5LB,BAG,0,0,0,0,5,10.55
3270,Sesame Seed Blk 8oz,BOT,3625,3796,171,0,1,2.46
3270,Sesame Seed Blk 8oz,BOT,0,0,0,0,5,2.46
3280,Tapioca (Spring Roll Wrap) Paper 50pc,EACH,14254,15757,1503,0,1,29.10
3280,Tapioca (Spring Roll Wrap) Paper 50pc,EACH,0,0,0,0,5,29.10
3289,Fried Onion,EACH,0,0,0,12600,1,36.00
3289,Fried Onion,EACH,0,0,0,0,5,36.00
3290,Fried Onions 10/1kg,EACH,20560,24880,4320,0,1,26.00
3290,Fried Onions 10/1kg,EACH,0,0,0,0,5,26.00
3403,Kikk Sushi Sauce  0.5 gal,BOT,0,0,0,0,1,6.92
3403,Kikk Sushi Sauce  0.5 gal,BOT,0,0,0,0,5,6.92
3404,Sushi Sauce Case  4/gal,BOT,837,1733,896,0,1,55.96
3406,Kik Ponzu Sauce 500pc,CS,296,358,62,0,1,14.18
3406,Kik Ponzu Sauce 500pc,CS,0,0,0,0,5,14.18
3409,Wasabi Sauce 0.5G,BOT,398,463,65,0,1,9.43
3409,Wasabi Sauce 0.5G,BOT,0,0,0,0,5,9.43
3412,Premium Spicy Sauce 0.5G,BOT,324,882,558,0,1,11.65
3412,Premium Spicy Sauce 0.5G,BOT,0,0,0,0,5,11.65
3415,Hot Garlic Sauce,BOT,622,710,88,0,1,16.50
3415,Hot Garlic Sauce,BOT,0,0,0,0,5,16.50
3418,Sweet  Chili SA 200,CS,-17,103,120,0,1,21.46
3418,Sweet  Chili SA 200,CS,0,0,0,0,5,21.46
3419,Chili Oil for Sushi,CS,25,25,0,0,1,35.94
3420,Chili Oil for Hot Food,CS,8,8,0,0,1,32.56
3424,Spicy Sesame Oil,BOT,509,622,113,0,1,14.70
3424,Spicy Sesame Oil,BOT,0,0,0,0,5,14.70
3427,Sriracha L 28oz,BOT,4679,5482,803,0,1,2.13
3427,Sriracha L 28oz,BOT,0,0,0,0,5,2.13
3429,Katsu Sauce 6/cs,BOT,22,22,0,0,1,6.20
3430,**AFC Basic Sauce,CS,31,42,11,0,1,25.32
3430,**AFC Basic Sauce,CS,0,0,0,0,5,25.32
3432,Chicken Bouillon Powder,CS,0,0,0,0,1,27.30
3432,Chicken Bouillon Powder,CS,0,0,0,0,5,27.30
3433,**AFC Orange Sauce,CS,398,431,33,0,1,23.52
3433,**AFC Orange Sauce,CS,0,0,0,0,5,23.52
3435,**AFC Sesame Sauce,CS,294,308,14,0,1,23.55
3435,**AFC Sesame Sauce,CS,0,0,0,0,5,23.55
3436,**AFC Stir Fry Sauce,CS,118,129,11,0,1,24.00
3436,**AFC Stir Fry Sauce,CS,0,0,0,0,5,24.00
3437,**Sweet & Sour Sauce,BOT,578,598,20,0,1,5.73
3437,**Sweet & Sour Sauce,BOT,0,0,0,0,5,5.73
3438,**AFC Yakiniku Sauce,BOT,740,740,0,0,1,12.63
3438,**AFC Yakiniku Sauce,BOT,0,0,0,0,5,12.63
3439,Micro Noodle Bowl 38oz,CS,0,0,0,0,1,43.32
3439,Micro Noodle Bowl 38oz,CS,0,0,0,0,5,43.32
3440,Mushroom Bouillon Powder 12/CS,EACH,36,36,0,0,1,2.21
3443,**Classic Teriyaki Sauce 12 bag/1kg,BAG,1956,3012,1056,0,1,27.00
3443,**Classic Teriyaki Sauce 12 bag/1kg,BAG,0,0,0,0,5,27.00
3445,AFC Sweet & Spicy Dipping Sauce,CS,458,479,21,0,1,47.20
3445,AFC Sweet & Spicy Dipping Sauce,CS,0,0,0,0,5,47.20
3447,AFC Spicy Bomb Sauce,CASE,-2,0,2,0,1,52.00
3447,AFC Spicy Bomb Sauce,CASE,0,0,0,0,5,52.00
3448,Yakisoba Sauce,BOT,174,182,8,0,1,7.57
3448,Yakisoba Sauce,BOT,0,0,0,0,5,7.57
3463,Men Tsuyu  (Soup Base) 12/16oz,BOT,192,192,0,0,1,2.95
3463,Men Tsuyu  (Soup Base) 12/16oz,BOT,0,0,0,0,5,2.95
3466,Creamy Sesame Dressing 6/32oz,CS,15,15,0,0,1,40.50
3468,Chinese Style Sesame Dressing,CS,7,7,0,0,1,58.80
3485,Miso Ramen Soup 6/2kg,BOT,98,110,12,0,1,20.78
3485,Miso Ramen Soup 6/2kg,BOT,0,0,0,0,5,20.78
3491,Premium AFC Poke Sauce 8/720g,CS,490,552,62,0,1,69.00
3491,Premium AFC Poke Sauce 8/720g,CS,0,0,0,0,5,69.00
3604,Retail Pickeled Ginger Calif Cup,BOT,5784,6468,684,0,1,7.80
3605,Sushi Gari BOT,BOT,41508,46068,4560,0,1,10.80
3605,Sushi Gari BOT,BOT,0,0,0,0,5,10.80
3610,R Sesame 4oz,BOT,17508,19896,2388,0,1,8.04
3610,R Sesame 4oz,BOT,0,0,0,0,5,8.04
3615,Grated Wasabi,EACH,-580,1260,1840,0,1,23.40
3615,Grated Wasabi,EACH,0,0,0,0,5,23.40
3635,Retail Sushi Seaweed 50pk,CS,253,321,68,0,1,24.62
3635,Retail Sushi Seaweed 50pk,CS,0,0,0,0,5,24.62
3640,Green Tea  24 Can,CS,1398,1589,191,0,1,12.25
3640,Green Tea  24 Can,CS,0,0,0,0,5,12.25
3647,Soy Sauce Bottle,BOT,0,0,0,0,1,13.68
3647,Soy Sauce Bottle,BOT,0,0,0,0,5,13.68
3648,Soy Sauce Bottle 24 cs,BOT,52560,55272,2712,0,1,30.00
3650,S Vineger,BOT,0,0,0,0,1,18.72
3650,S Vineger,BOT,0,0,0,0,5,18.72
3655,Tofu Miso Soup 24/CS,CS,912,1055,143,0,1,14.10
3655,Tofu Miso Soup 24/CS,CS,0,0,0,0,5,14.10
3660,Veg. Miso Soup 24/CS,CS,1243,1340,97,0,1,13.81
3660,Veg. Miso Soup 24/CS,CS,0,0,0,0,5,13.81
3805,Yellow Soy Wrapper 20/10pks,CS,0,0,0,0,1,65.00
3805,Yellow Soy Wrapper 20/10pks,CS,0,0,0,0,5,65.00
3808,Mango Chipotle Origami Wraps 50pk/cs,PACK,0,0,0,0,1,12.00
3808,Mango Chipotle Origami Wraps 50pk/cs,PACK,0,0,0,0,5,12.00
3809,Color Soy Wrap,PK,345,377,32,0,1,2.50
3809,Color Soy Wrap,PK,0,0,0,0,5,2.50
3810,Soy Wrap Nori White,CS,0,0,0,0,1,108.50
3810,Soy Wrap Nori White,CS,0,0,0,0,5,108.50
3820,Kosher Ginger,EACH,0,0,0,0,1,29.00
3820,Kosher Ginger,EACH,0,0,0,0,5,29.00
3825,Kosher Wasabi 1KG,EACH,31,31,0,0,1,7.50
3825,Kosher Wasabi 1KG,EACH,0,0,0,0,5,7.50
3830,Kosher Nori 12/30sh,CS,5,5,0,0,1,141.00
3830,Kosher Nori 12/30sh,CS,0,0,0,0,5,141.00
3840,Natural Ginger 20LB,EACH,18,18,0,0,1,30.00
3840,Natural Ginger 20LB,EACH,0,0,0,0,5,30.00
3850,Natural Wasabi 2.2LB,BAG,31,31,0,0,1,5.47
3850,Natural Wasabi 2.2LB,BAG,0,0,0,0,5,5.47
3860,Natural Vin Orange 5.28gal,CS,0,0,0,0,1,30.36
3860,Natural Vin Orange 5.28gal,CS,0,0,0,0,5,30.36
3870,Beet Root Chips,BAG,18,18,0,0,1,28.25
3871,Okra Chips,BAG,18,18,0,0,1,24.55
3999,Vegetarian Oyster Sauce 4/CS,BOT,72,72,0,0,1,5.59
4192,Yamachan Ramen 40/CS,CS,0,0,0,0,1,20.80
4777,CH-82 Fold Tray,PK,0,0,0,0,1,2.55
4777,CH-82 Fold Tray,PK,0,0,0,0,5,2.55
4998,16 oz MIC Bowl Set 50 pcs,PK,0,0,0,0,1,0.00
4998,16 oz MIC Bowl Set 50 pcs,PK,0,0,0,0,5,0.00
5110,FET 1.0 Eco Tray Body 100pc,PK,-8,-8,0,0,1,14.00
5111,FET 1.0 Eco Tray Lid 50pc,PK,-8,-8,0,0,1,3.95
5115,FET  1.5 Eco Tray Body 100pc,PK,-40,-40,0,0,1,18.42
5116,FET-1.5 Eco Tray Lid 50pc,PK,-72,-72,0,0,1,4.56
5125,AFC H1 Heart Cont Body 20 PC,PK,9430,9641,211,0,1,6.77
5125,AFC H1 Heart Cont Body 20 PC,PK,0,0,0,0,5,6.77
5130,AFC H1 Heart Lid 20 PC,PK,9384,9617,233,0,1,5.31
5130,AFC H1 Heart Lid 20 PC,PK,0,0,0,0,5,5.31
5145,AFC-16 Clear Body,PK,2286,2657,371,0,1,2.91
5145,AFC-16 Clear Body,PK,0,0,0,0,5,2.91
5150,AFC-16 Lid  Pack,PK,2319,2708,389,0,1,2.37
5150,AFC-16 Lid  Pack,PK,0,0,0,0,5,2.37
5155,AFC-4 Blue Body Pack,PK,48958,53014,4056,0,1,2.72
5155,AFC-4 Blue Body Pack,PK,0,0,0,0,5,2.72
5155A,R1.0 (AFC-4) Blue Set CS 8/50pc/CS,CS,6,6,0,0,1,39.28
5155B,R1.0 (AFC-4) Blue Set PK,PK,-88,-88,0,0,1,4.91
5160,AFC-4 Lid  Pack,PK,50709,54732,4023,0,1,2.36
5160,AFC-4 Lid  Pack,PK,0,0,0,0,5,2.36
5165,AFC-5 Blue Body Pack,PK,9346,10288,942,0,1,3.10
5165,AFC-5 Blue Body Pack,PK,0,0,0,0,5,3.10
5170,AFC-5 Lid Pack,PK,8567,9554,987,0,1,2.84
5170,AFC-5 Lid Pack,PK,0,0,0,0,5,2.84
5175,AFC-20 Blue Body Pack,PK,12671,13016,345,0,1,3.20
5175,AFC-20 Blue Body Pack,PK,0,0,0,0,5,3.20
5175A,SK-20 Blue Set CS 6/50pc/set cs,CS,0,0,0,0,1,34.98
5175B,SK-20 (AFC-20) Set PK,PK,45,45,0,0,1,5.83
5175S,AFC-20 Sakura Body 16/50pc,PK,864,864,0,0,1,8.23
5176,AFC-20 Clear Body,PK,7683,9770,2087,0,1,3.14
5176,AFC-20 Clear Body,PK,0,0,0,0,5,3.14
5180,AFC-20 Lid  Pack,PK,17429,19712,2283,0,1,2.84
5180,AFC-20 Lid  Pack,PK,0,0,0,0,5,2.84
5181,AFC-20 Compostable Body,PK,2230,2230,0,0,1,3.77
5182,AFC-20 Compostable Lid,PK,2230,2230,0,0,1,6.07
5185,AFC-30 Blue Body Pack,PK,54447,56291,1844,0,1,3.97
5185,AFC-30 Blue Body Pack,PK,0,0,0,0,5,3.97
5185A,SK-30 Blue Set Cs 6/50pc/set cs,CS,0,0,0,0,1,41.34
5185B,SK-30 (AFC-30) Set PK,PK,0,0,0,0,1,6.89
5185S,AFC-30 Sakura Body 16/50pc/cs,PK,1792,1792,0,0,1,8.90
5186,AFC-30 Clear Body,PK,19786,23613,3827,0,1,3.88
5186,AFC-30 Clear Body,PK,0,0,0,0,5,3.88
5190,AFC-30 Lid Pack,PK,92181,97506,5325,0,1,3.16
5190,AFC-30 Lid Pack,PK,0,0,0,0,5,3.16
5191,AFC-30 Compostable Body,PK,8639,8639,0,0,1,4.92
5192,AFC-30 Compostable Lid,PK,8879,8879,0,0,1,7.75
5195,AFC-40 Blue Body Pack,PK,7016,7844,828,0,1,4.79
5195,AFC-40 Blue Body Pack,PK,0,0,0,0,5,4.79
5195A,SK-40 Blue Set CS 6/50pc/set/CS,CS,0,0,0,0,1,49.14
5195B,SK-40 (AFC-40) Set PK,PK,12,12,0,0,1,8.19
5195S,AFC-40 Sakura Body 16/50pc/cs,PK,640,640,0,0,1,9.66
5196,AFC-40 Clear Body,PK,3916,4656,740,0,1,4.66
5196,AFC-40 Clear Body,PK,0,0,0,0,5,4.66
5199,AFC-40 Lid Pack,PK,13304,14884,1580,0,1,3.68
5199,AFC-40 Lid Pack,PK,0,0,0,0,5,3.68
5200,ST-201 Manyo Body,PK,0,0,0,0,1,9.19
5200,ST-201 Manyo Body,PK,0,0,0,0,5,9.19
5201,AFC-40 Compostable Body,PK,3103,3103,0,0,1,6.78
5202,AFC-40 Compostable Lid,PK,3103,3103,0,0,1,8.98
5203,CV-11B Body (BF-18),PK,0,0,0,0,1,3.60
5203,CV-11B Body (BF-18),PK,0,0,0,0,5,3.60
5204,CV-11F Lid  (BF-18),PK,0,0,0,0,1,2.25
5204,CV-11F Lid  (BF-18),PK,0,0,0,0,5,2.25
5205,ST-201 Blue Body,PK,2864,3510,646,0,1,3.44
5205,ST-201 Blue Body,PK,0,0,0,0,5,3.44
5210,ST-201 Lid Pk,PK,5059,5714,655,0,1,2.82
5210,ST-201 Lid Pk,PK,0,0,0,0,5,2.82
5215,ST-202 Blue Body Pack,PK,8834,10318,1484,0,1,4.39
5215,ST-202 Blue Body Pack,PK,0,0,0,0,5,4.39
5220,ST-202 Lid  PACK,PK,12637,14137,1500,0,1,3.28
5220,ST-202 Lid  PACK,PK,0,0,0,0,5,3.28
5225,ST-218 MANYO BODY,PK,1462,1478,16,0,1,9.34
5225,ST-218 MANYO BODY,PK,0,0,0,0,5,9.34
5230,ST-218 Blue Body Pk,PK,9624,10701,1077,0,1,5.37
5230,ST-218 Blue Body Pk,PK,0,0,0,0,5,5.37
5235,ST-218 LID  PACK,PK,10105,11038,933,0,1,3.80
5235,ST-218 LID  PACK,PK,0,0,0,0,5,3.80
5240,ST-202 Manyo Body,PK,538,554,16,0,1,7.46
5240,ST-202 Manyo Body,PK,0,0,0,0,5,7.46
5245,ST-4 Blue BD 50,PK,15782,17540,1758,0,1,3.06
5245,ST-4 Blue BD 50,PK,0,0,0,0,5,3.06
5251,ST-4 Lid Pack  50,PK,15732,17538,1806,0,1,2.40
5251,ST-4 Lid Pack  50,PK,0,0,0,0,5,2.40
5255,ST-4 Manyo Body,PK,921,969,48,0,1,4.34
5255,ST-4 Manyo Body,PK,0,0,0,0,5,4.34
5265,ST-5 Blue BD 50,PK,2108,2234,126,0,1,3.25
5265,ST-5 Blue BD 50,PK,0,0,0,0,5,3.25
5270,ST-5 Lid Pack 50,PK,4807,4933,126,0,1,2.89
5270,ST-5 Lid Pack 50,PK,0,0,0,0,5,2.89
5276,ST-5 Manyo Body,PK,2809,2809,0,0,1,10.55
5276,ST-5 Manyo Body,PK,0,0,0,0,5,10.55
5277,MH-30.(ZX-30) Sushi Tray 50pc/Set,SET,247,247,0,0,1,9.50
5278,MH-40 (DO-3) Sushi Tray 50pc/Set,SET,-56,-56,0,0,1,11.25
5279,MH-35 Sushi Tray 50pc/set,SET,124,124,0,0,1,9.00
5280,MH-10 (B-011).(AFC-4) 50pc/pk,SET,-48,-48,0,0,1,6.25
5281,MH-15  (AFC-5)  100pc/pk,SET,-679,-679,0,0,1,10.50
5282,SU-CS-75 100pc/set (AFC4),SET,750,750,0,0,1,6.32
5283,JFC -18 Tray (OP-510)  50pc/set,SET,3924,4023,99,0,1,5.67
5284,MH-06 (20)  Tray Set,SET,-1138,-1138,0,0,1,5.65
5285,Produce Bag,EACH,0,0,0,0,1,10.00
5285,Produce Bag,EACH,0,0,0,0,5,10.00
5286,MH-50  (40) Clear Tray Set,SET,492,492,0,0,1,15.25
5287,TTM 24oz Bottom 100pc/pk(AFC4),PK,-15,-15,0,0,1,11.89
5288,TTM 24 oz Lid 100pc/pk (AFC4),PK,243,243,0,0,1,9.54
5289,53205 Body 100pc/pk (AFC 30),PK,-13,-13,0,0,1,9.00
5290,53205L-1 Lid 100pc/pk (AFC30),PK,-311,-281,30,0,1,9.75
5300,32oz Bowl 300pc. Sabert,CS,18,19,1,0,1,45.90
5300,32oz Bowl 300pc. Sabert,CS,0,0,0,0,5,45.90
5301,32oz Bowl Lid 300pc. Sabert,CS,20,21,1,0,1,47.26
5301,32oz Bowl Lid 300pc. Sabert,CS,0,0,0,0,5,47.26
5302,32oz Bowl 150pc.Anchor 150pc,CS,-8,-6,2,50,1,34.83
5302,32oz Bowl 150pc.Anchor 150pc,CS,0,0,0,0,5,34.83
5303,32oz Bowl Lid. 150pc. Anchor 150pc,CS,-2,0,2,56,1,26.95
5303,32oz Bowl Lid. 150pc. Anchor 150pc,CS,0,0,0,0,5,26.95
5305,BO-SC-U24 Bowl 24oz 500pc WC,CS,21,24,3,0,1,79.45
5305,BO-SC-U24 Bowl 24oz 500pc WC,CS,0,0,0,0,5,79.45
5306,BOL-CS-24 Bowl Lid 24oz 300pc WC,CS,-11,-6,5,0,1,46.70
5306,BOL-CS-24 Bowl Lid 24oz 300pc WC,CS,0,0,0,0,5,46.70
5307,BG-ST-4 Compostable Body 800pc,CS,21,21,0,0,1,77.20
5307,BG-ST-4 Compostable Body 800pc,CS,0,0,0,0,5,77.20
5308,BG-ST-4 Compostable Lid 800pc,CS,28,28,0,0,1,92.65
5308,BG-ST-4 Compostable Lid 800pc,CS,0,0,0,0,5,92.65
5309,32oz Bowl Body Stalk L014 500pc,CS,22,22,0,0,1,71.90
5309,32oz Bowl Body Stalk L014 500pc,CS,0,0,0,0,5,71.90
5310,32oz Lid Table ware DL32 200pc,CS,14,14,0,0,1,40.56
5310,32oz Lid Table ware DL32 200pc,CS,0,0,0,0,5,40.56
5311,24oz Bowl BG-BO24R1 500pc,CS,30,30,0,0,1,69.18
5311,24oz Bowl BG-BO24R1 500pc,CS,0,0,0,0,5,69.18
5312,24oz Lid BG-Bo24 PL 500pc,CS,75,75,0,0,1,64.20
5312,24oz Lid BG-Bo24 PL 500pc,CS,0,0,0,0,5,64.20
5313,White Diamond Ramen Bowl,CS,-8,2,10,0,1,55.38
5314,EP-SH2 5X7 BLK SUSHI TRAY 600PC,CS,26,26,0,0,1,96.75
5315,EP-SH3 6X9 BLK SUSHI TRAY 600PC,CS,30,30,0,0,1,137.62
5316,Anchor M612 Base,CS,0,0,0,0,1,65.50
5317,Anchor LH600 Lid,CS,0,0,0,0,1,60.90
5318,Anchor M424-B Base,CS,24,24,0,0,1,36.85
5319,Anchor LH4LD-NB Lid,CS,24,24,0,0,1,31.75
5320,Don-S Bowl 50pcs/16pks,CS,17,17,0,0,1,214.00
5321,Don-S Lid 50pcs/16pks,CS,17,17,0,0,1,144.00
5322,Sabert D300 Base 100pc/pk (AFC 5),PK,179,179,0,0,1,15.04
5323,Sabert D300 Lid 50pc/pk (AFC 5),PK,482,482,0,0,1,7.52
5324,Sabert B300N Base HT 300pc/cs,CS,49,49,0,0,1,56.25
5325,Sabert B300N Lid HT300pc/cs,CS,49,49,0,0,1,60.50
5410,BF-18 Salad Cont Body50pc/24/CS,PK,0,0,0,0,1,4.35
5411,BF-18 Salad Tray Lid 50pc/24/cs,PK,0,0,0,0,1,3.78
5412,AFC-18 White Body,PK,2072,2824,752,0,1,3.83
5412,AFC-18 White Body,PK,0,0,0,0,5,3.83
5416,AFC-18 Lid  50 pcs,PK,1845,2533,688,0,1,3.91
5416,AFC-18 Lid  50 pcs,PK,0,0,0,0,5,3.91
5475,KL Hana-310,PK,1,1,0,0,1,2.07
5475,KL Hana-310,PK,0,0,0,0,5,2.07
5481,B&H 16 Bowl Body Pack,PK,90,90,0,0,1,5.61
5481,B&H 16 Bowl Body Pack,PK,0,0,0,0,5,5.61
5482,B&H 16 Bowl Lid Pack,PK,90,90,0,0,1,3.25
5482,B&H 16 Bowl Lid Pack,PK,0,0,0,0,5,3.25
5483,B&H 16 Bowl Middle,PK,90,90,0,0,1,2.01
5483,B&H 16 Bowl Middle,PK,0,0,0,0,5,2.01
55,PR TUNA10# 02/06/19,CS,0,0,0,0,1,150.00
55,PR TUNA10# 02/06/19,CS,0,0,0,0,5,150.00
56,ULT Tuna 12/16/20 . Manuf.Nov.. 2020,CS,0,0,0,0,1,84.54
56,ULT Tuna 12/16/20 . Manuf.Nov.. 2020,CS,0,0,0,0,5,84.54
5601,AFC-235 Party Tray Body 50pc,PK,-84,-84,0,0,1,15.00
5601,AFC-235 Party Tray Body 50pc,PK,0,0,0,0,5,15.00
5602,AFC-235 Party Tray  Lid  50pc,PK,-82,-82,0,0,1,12.15
5602,AFC-235 Party Tray  Lid  50pc,PK,0,0,0,0,5,12.15
5603,AFC-40L  MW Inner 50pc x 20pk,PK,3938,3938,0,0,1,6.29
5603,AFC-40L  MW Inner 50pc x 20pk,PK,0,0,0,0,5,6.29
5604,AFC-40S MW INNER 50pc x 48,PK,31,31,0,0,1,5.67
5604,AFC-40S MW INNER 50pc x 48,PK,0,0,0,0,5,5.67
5605,AFC-235 Party Tray Body 50pc/PK,PK,2269,2475,206,0,1,17.95
5605,AFC-235 Party Tray Body 50pc/PK,PK,0,0,0,0,5,17.95
5610,AFC-235 Party Ty Lid 50pc/PK,PK,2269,2341,72,0,1,14.54
5610,AFC-235 Party Ty Lid 50pc/PK,PK,0,0,0,0,5,14.54
5615,SF-275(SF-3) Asaoke body,PK,3839,3839,0,0,1,2.88
5615,SF-275(SF-3) Asaoke body,PK,0,0,0,0,5,2.88
5616,AFC-275 Party Tray Body 6/50pc,PK,1632,1632,0,0,1,13.90
5617,AFC-275 Party Tray Lid 6/50pc,PK,1820,1821,1,0,1,10.70
5620,SF-275 (SF-3) Shachi Lid,PK,3839,3839,0,0,1,2.21
5620,SF-275 (SF-3) Shachi Lid,PK,0,0,0,0,5,2.21
5625,SF-355 Body (SF-5),PK,1935,1947,12,0,1,4.48
5625,SF-355 Body (SF-5),PK,0,0,0,0,5,4.48
5630,SF-355 Lid  Pack SF-5,PK,1863,1875,12,0,1,3.42
5630,SF-355 Lid  Pack SF-5,PK,0,0,0,0,5,3.42
5635,SF-7 Oke Body,PK,466,475,9,0,1,9.54
5635,SF-7 Oke Body,PK,0,0,0,0,5,9.54
5640,SF-7 Lid  Pack 10pc,PK,465,474,9,0,1,6.19
5640,SF-7 Lid  Pack 10pc,PK,0,0,0,0,5,6.19
5645,SF-55 White Bowl Body 50pc,PK,6429,7024,595,0,1,4.98
5645,SF-55 White Bowl Body 50pc,PK,0,0,0,0,5,4.98
5646,SF-55 Bowl Lid 50pc,PK,6640,7234,594,0,1,3.06
5646,SF-55 Bowl Lid 50pc,PK,0,0,0,0,5,3.06
5647,SF-55 Inner 200pc/12pk,PK,657,658,1,0,1,9.71
5647,SF-55 Inner 200pc/12pk,PK,0,0,0,0,5,9.71
5648,TO-NB24 150sets/cs (SF55),CS,43,43,0,0,1,46.65
5653,Donburi Bowl Set DB-103,SET,70,120,50,60,1,10.38
5653,Donburi Bowl Set DB-103,SET,0,0,0,0,5,10.38
5661,Football Tray  Each 50 pc,EACH,0,0,0,3050,1,0.60
5661,Football Tray  Each 50 pc,EACH,0,0,0,0,5,0.60
5670,AFC-355 Sakura Body Pty Tray 8/10pc/cs,PK,744,744,0,0,1,28.28
5671,AFC-355 Sakura Lid  8/10pc/cs,PK,744,744,0,0,1,9.70
5680,AFC-7 Sakura Body 6/10pc/cs,PK,300,300,0,0,1,32.02
5681,AFC-7 Sakura Lid 6/10pc/cs,PK,300,300,0,0,1,11.41
57,ULT 5# 12/16/20. Manu. Nov.. 2020,CS,0,0,0,0,1,84.54
57,ULT 5# 12/16/20. Manu. Nov.. 2020,CS,0,0,0,0,5,84.54
5752,White Micro Bowls 36 oz,CS,0,0,0,0,1,43.12
5752,White Micro Bowls 36 oz,CS,0,0,0,0,5,43.12
5805,PLA ST-4 Cont. Set 400pc,CASE,-9,-9,0,0,1,124.80
5805,PLA ST-4 Cont. Set 400pc,CASE,0,0,0,0,5,124.80
5810,ECO 1.5 Compostable Lid,CS,-3,-3,0,0,1,34.00
5810,ECO 1.5 Compostable Lid,CS,0,0,0,0,5,34.00
5811,ECO 1.5 Compostable Tray,CS,-3,-3,0,0,1,38.00
5811,ECO 1.5 Compostable Tray,CS,0,0,0,0,5,38.00
5812,EG 2.0 Compostable Lid,CS,-4,-4,0,0,1,74.69
5812,EG 2.0 Compostable Lid,CS,0,0,0,0,5,74.69
5813,EG 2.0 Compostable Base,CS,-3,-3,0,0,1,89.00
5813,EG 2.0 Compostable Base,CS,0,0,0,0,5,89.00
5816,BF-8 Curry White Body 50pc,PACK,0,0,0,0,1,7.16
5816,BF-8 Curry White Body 50pc,PACK,0,0,0,0,5,7.16
5817,BF-8 Curry Lid  50pc,PACK,0,0,0,0,1,5.51
5817,BF-8 Curry Lid  50pc,PACK,0,0,0,0,5,5.51
5818,Compostable Bowl BO-SC-U24 500pc,CASE,0,0,0,0,1,79.45
5818,Compostable Bowl BO-SC-U24 500pc,CASE,0,0,0,0,5,79.45
5819,Compostable Lid BOL-CS-24 300pc,CASE,0,0,0,0,1,46.70
5819,Compostable Lid BOL-CS-24 300pc,CASE,0,0,0,0,5,46.70
5820,COR-R20 Body Pk 8/50pc,PK,0,0,0,0,1,4.03
5820,COR-R20 Body Pk 8/50pc,PK,0,0,0,0,5,4.03
5822,COR-R20 Lid 8/50pc,PK,0,0,0,0,1,3.58
5822,COR-R20 Lid 8/50pc,PK,0,0,0,0,5,3.58
5823,COP-R15 Body PK 50pc,PK,519,539,20,0,1,3.54
5823,COP-R15 Body PK 50pc,PK,0,0,0,0,5,3.54
5824,COP-R15 Lid PK 50pc,PK,498,518,20,0,1,3.22
5824,COP-R15 Lid PK 50pc,PK,0,0,0,0,5,3.22
5827,COP-18 Poke Bowl  Body Pk,PK,-165,126,291,0,1,5.46
5827,COP-18 Poke Bowl  Body Pk,PK,0,0,0,0,5,5.46
5829,COP-18 Poke Bowl  Lid  Pk,PK,-667,-308,359,0,1,4.60
5829,COP-18 Poke Bowl  Lid  Pk,PK,0,0,0,0,5,4.60
5830,2 oz Cup  100pc/pk,PK,363,371,8,0,1,1.16
5830,2 oz Cup  100pc/pk,PK,0,0,0,0,5,1.16
5835,2 oz Lid  100pc/pk,PK,421,428,7,0,1,1.16
5835,2 oz Lid  100pc/pk,PK,0,0,0,0,5,1.16
5836,2 oz Microwaveable Cup and Lid,CS,0,0,0,210,1,71.34
5840,Cup 90MB 4 oz  50pc,PK,1305,1543,238,0,1,2.73
5840,Cup 90MB 4 oz  50pc,PK,0,0,0,0,5,2.73
5845,Cup 90TC 4 oz Lid  50 pc,PK,620,842,222,0,1,2.43
5845,Cup 90TC 4 oz Lid  50 pc,PK,0,0,0,0,5,2.43
5860,Demo Cup  20PK/CS,PK,461,461,0,0,1,2.85
5860,Demo Cup  20PK/CS,PK,0,0,0,0,5,2.85
5889,Sample Tray Dome,EACH,124,124,0,0,1,149.80
5889,Sample Tray Dome,EACH,0,0,0,0,5,149.80
5999,Sampling Dome Kit,EACH,0,0,0,0,1,341.96
5999,Sampling Dome Kit,EACH,0,0,0,0,5,341.96
6110,Baran Box 1000 pcs,PK,6363,7315,952,0,1,0.88
6110,Baran Box 1000 pcs,PK,0,0,0,0,5,0.88
6120,Chopstick 100PR,PK,27014,30245,3231,0,1,1.04
6120,Chopstick 100PR,PK,0,0,0,0,5,1.04
6121,Wild Blue Chopstick 40pks,PK,9634,9634,0,0,1,1.10
6121,Wild Blue Chopstick 40pks,PK,0,0,0,0,5,1.10
6130,Chopkstick Special 100,PK,200,200,0,0,1,1.00
6130,Chopkstick Special 100,PK,0,0,0,0,5,1.00
6140,Edamame  Sleeve White 100pc,PK,1100,1106,6,0,1,17.00
6140,Edamame  Sleeve White 100pc,PK,0,0,0,0,5,17.00
6175,Towel,EACH,0,0,0,0,1,0.00
6175,Towel,EACH,0,0,0,0,5,0.00
6200,Thermo  B.R. Gradient,ROLL,0,0,0,0,1,7.50
6200,Thermo  B.R. Gradient,ROLL,0,0,0,0,5,7.50
6201,White Mini Sticker,ROLL,111,111,0,0,1,12.50
6201,White Mini Sticker,ROLL,0,0,0,0,5,12.50
6208,Thermo Vertical Blue #3,ROLL,4389,8476,4087,3840,1,5.75
6208,Thermo Vertical Blue #3,ROLL,0,0,0,0,5,5.75
6210,Thermo Vertical Brown Rice #3,ROLL,0,0,0,0,1,5.75
6210,Thermo Vertical Brown Rice #3,ROLL,0,0,0,0,5,5.75
6220,12024T Freshpak Bowl 300,CS,0,0,0,0,1,93.12
6220,12024T Freshpak Bowl 300,CS,0,0,0,0,5,93.12
6221,Freshpak Bowl Lid 52032t 300pc,CS,0,0,0,0,1,62.62
6221,Freshpak Bowl Lid 52032t 300pc,CS,0,0,0,0,5,62.62
6222,Vertical Label Wild Blue,ROLL,430,468,38,0,1,7.39
6248,Vertical  No Logo,ROLL,189,189,0,0,1,5.80
6248,Vertical  No Logo,ROLL,0,0,0,0,5,5.80
6258,Vert. Robert Fresh Label,ROLL,273,273,0,144,1,6.25
6258,Vert. Robert Fresh Label,ROLL,0,0,0,0,5,6.25
6261,Lab. Vertical Nob Hill,ROLL,938,953,15,0,1,7.24
6261,Lab. Vertical Nob Hill,ROLL,0,0,0,0,5,7.24
6262,Lab. Vertical Raleys,ROLL,-108,-72,36,0,1,7.24
6262,Lab. Vertical Raleys,ROLL,0,0,0,0,5,7.24
6263,Lab. Vertical Bel Air,ROLL,988,1000,12,0,1,7.24
6263,Lab. Vertical Bel Air,ROLL,0,0,0,0,5,7.24
6266,Lab. Vertical Olo,ROLL,240,240,0,0,1,7.24
6266,Lab. Vertical Olo,ROLL,0,0,0,0,5,7.24
6267,Lab Vertical Oishisa,ROLL,117,117,0,0,1,7.24
6267,Lab Vertical Oishisa,ROLL,0,0,0,0,5,7.24
6268,Lab. Vertical PRC Market 32,ROLL,1107,1107,0,384,1,6.25
6268,Lab. Vertical PRC Market 32,ROLL,0,0,0,0,5,6.25
6269,Lab. Vertical Draegers,ROLL,1,1,0,0,1,7.24
6269,Lab. Vertical Draegers,ROLL,0,0,0,0,5,7.24
6270,Lab Vertical Rouses,ROLL,1053,1134,81,0,1,7.24
6270,Lab Vertical Rouses,ROLL,0,0,0,0,5,7.24
6271,Lab. Vert. Metropolitan,ROLL,517,533,16,0,1,7.24
6271,Lab. Vert. Metropolitan,ROLL,0,0,0,0,5,7.24
6273,Lab. Vertical Walgreen (Red Grad),ROLL,8,8,0,0,1,7.24
6273,Lab. Vertical Walgreen (Red Grad),ROLL,0,0,0,0,5,7.24
6275,Vert. Lake View Label,ROLL,196,196,0,0,1,6.25
6275,Vert. Lake View Label,ROLL,0,0,0,0,5,6.25
6285,Thermo Vertical Yamato,ROLL,1496,1496,0,0,1,6.25
6285,Thermo Vertical Yamato,ROLL,0,0,0,0,5,6.25
6290,Thermo Verti Yamato Brown,ROLL,1201,1201,0,0,1,6.25
6290,Thermo Verti Yamato Brown,ROLL,0,0,0,0,5,6.25
6291,Thermo Kosher Vert.Purple,ROLL,139,149,10,0,1,7.24
6291,Thermo Kosher Vert.Purple,ROLL,0,0,0,0,5,7.24
6292,Thermal Vertical Stonefish Label,ROLL,232,232,0,0,1,8.00
6292,Thermal Vertical Stonefish Label,ROLL,0,0,0,0,5,8.00
6293,Microwave Instructions AFC 40L Sticker,ROLL,60,64,4,0,1,8.90
6293,Microwave Instructions AFC 40L Sticker,ROLL,0,0,0,0,5,8.90
6294,PUBLIX $5 WEDNESDAY STICKER,ROLL,109,181,72,0,1,6.96
6294,PUBLIX $5 WEDNESDAY STICKER,ROLL,0,0,0,0,5,6.96
6295,Sticker 3 Min. Microwave,EACH,91,102,11,0,1,4.95
6295,Sticker 3 Min. Microwave,EACH,0,0,0,0,5,4.95
6296,$5 Red Sticker,ROLL,1145,1399,254,907,1,4.41
6296,$5 Red Sticker,ROLL,0,0,0,0,5,4.41
6297,$5 Barcode Sticker,EACH,1850,1979,129,0,1,4.41
6297,$5 Barcode Sticker,EACH,0,0,0,0,5,4.41
6299,$5  Red  Sticker,ROLL,-6,-6,0,0,1,6.00
6299,$5  Red  Sticker,ROLL,0,0,0,0,5,6.00
6300,Convection Oven 1/4Sheet,EACH,0,0,0,0,1,545.00
6300,Convection Oven 1/4Sheet,EACH,0,0,0,0,5,545.00
6301,$6 Red Sticker,ROLL,839,839,0,0,1,6.00
6302,$9.99 Purple Sticker,ROLL,858,858,0,0,1,6.00
6303,50 Cent Off W/card,ROLL,907,909,2,0,1,6.00
6304,Warm Up Microwave Sticker,ROLL,1113,1253,140,0,1,2.66
6350,Bleach,EACH,0,0,0,0,1,0.00
6350,Bleach,EACH,0,0,0,0,5,0.00
6500,Wild Blue Spicy Sauce Ribbon,ROLL,19,19,0,0,1,6.23
6501,Wild Blue Pickled Ginger Ribbon,ROLL,19,19,0,0,1,6.23
6502,Wild Blue Wasabi Ribbon,ROLL,19,19,0,0,1,6.23
6503,Wild Blue Sushi Sauce Ribbon,ROLL,20,20,0,0,1,6.23
6601,BOGO Sticker,ROLL,68,68,0,0,1,8.10
6601,BOGO Sticker,ROLL,0,0,0,0,5,8.10
6603,Date Gun Label,ROLL,2766,2831,65,0,1,2.20
6603,Date Gun Label,ROLL,0,0,0,0,5,2.20
6606,Date Gun Label "Sell-By",ROLL,2934,3537,603,400,1,2.20
6606,Date Gun Label "Sell-By",ROLL,0,0,0,0,5,2.20
6609,"New" Sticker Yellow,ROLL,427,444,17,0,1,4.41
6609,"New" Sticker Yellow,ROLL,0,0,0,0,5,4.41
6612,Clear Chef Special Sticker,ROLL,-91,-86,5,0,1,5.99
6612,Clear Chef Special Sticker,ROLL,0,0,0,0,5,5.99
6615,Clear Fully Cooked Sticker,ROLL,389,403,14,0,1,5.99
6615,Clear Fully Cooked Sticker,ROLL,0,0,0,0,5,5.99
6618,Clear Ginger Dressing Sticker,ROLL,0,0,0,0,1,6.96
6618,Clear Ginger Dressing Sticker,ROLL,0,0,0,0,5,6.96
6621,Clear Hot Garlic Sticker,EACH,0,0,0,0,1,6.96
6621,Clear Hot Garlic Sticker,EACH,0,0,0,0,5,6.96
6624,Clear Dumpling  Microwave Instruction Sticker 250 pcs,ROLL,-89,-50,39,0,1,4.75
6624,Clear Dumpling  Microwave Instruction Sticker 250 pcs,ROLL,0,0,0,0,5,4.75
6627,Clear Spicy Sticker,ROLL,205,217,12,0,1,5.99
6627,Clear Spicy Sticker,ROLL,0,0,0,0,5,5.99
6629,Chef Special Sticker Red 250,ROLL,426,428,2,0,1,4.95
6629,Chef Special Sticker Red 250,ROLL,0,0,0,0,5,4.95
6633,Clear Vegatable Only Sticker,ROLL,205,210,5,0,1,5.99
6633,Clear Vegatable Only Sticker,ROLL,0,0,0,0,5,5.99
6636,P. Gari Label 250 Ribbon,ROLL,562,575,13,0,1,8.67
6636,P. Gari Label 250 Ribbon,ROLL,0,0,0,0,5,8.67
6639,P Wasa Label 250 Ribon,ROLL,243,252,9,0,1,7.45
6639,P Wasa Label 250 Ribon,ROLL,0,0,0,0,5,7.45
6642,P Spicy Sauce L 250 Ribbon,ROLL,508,566,58,100,1,7.45
6642,P Spicy Sauce L 250 Ribbon,ROLL,0,0,0,0,5,7.45
6645,P Wasabi Oishisa 250,ROLL,0,0,0,0,1,7.00
6645,P Wasabi Oishisa 250,ROLL,0,0,0,0,5,7.00
6648,P Ginger Oishisa 250,ROLL,0,0,0,0,1,7.00
6648,P Ginger Oishisa 250,ROLL,0,0,0,0,5,7.00
6649,P. Sushi Sauce  250. Clear,ROLL,165,220,55,200,1,7.45
6649,P. Sushi Sauce  250. Clear,ROLL,0,0,0,0,5,7.45
6651,Label Friedrice,ROLL,0,0,0,0,1,5.15
6651,Label Friedrice,ROLL,0,0,0,0,5,5.15
6657,Classic Yummy Sauce Label,PK,52,60,8,0,1,8.67
6657,Classic Yummy Sauce Label,PK,0,0,0,0,5,8.67
6666,Brown Rice Sticker Clear,EACH,638,651,13,0,1,5.67
6666,Brown Rice Sticker Clear,EACH,0,0,0,0,5,5.67
6669,Label. Spring Gard. Sheet,EACH,0,0,0,0,1,0.20
6669,Label. Spring Gard. Sheet,EACH,0,0,0,0,5,0.20
6672,Lab Sustain Sticker,ROLL,0,0,0,0,1,6.00
6672,Lab Sustain Sticker,ROLL,0,0,0,0,5,6.00
6673,Gluten Free Sticker 250,ROLL,0,0,0,0,1,8.00
6673,Gluten Free Sticker 250,ROLL,0,0,0,0,5,8.00
6675,Prep Item Label 500,ROLL,1532,1742,210,0,1,1.95
6675,Prep Item Label 500,ROLL,0,0,0,0,5,1.95
6676,Hot Bowl Sell By Stickers,ROLL,198,204,6,11,1,4.75
6676,Hot Bowl Sell By Stickers,ROLL,0,0,0,0,5,4.75
6677,$2 Off Red Sticker,ROLL,941,941,0,0,1,6.00
6678,$1 Off Sticker,ROLL,782,782,0,0,1,6.00
6678,$1 Off Sticker,ROLL,0,0,0,0,5,6.00
6679,Weekly Special Sticker,ROLL,0,0,0,0,1,5.25
6679,Weekly Special Sticker,ROLL,0,0,0,0,5,5.25
6685,Sticker. Grilled Chicken,ROLL,0,0,0,0,1,4.95
6685,Sticker. Grilled Chicken,ROLL,0,0,0,0,5,4.95
6968,Tablet. Aus. Label Machine,EACH,0,0,0,0,1,750.00
6968,Tablet. Aus. Label Machine,EACH,0,0,0,0,5,750.00
6969,Printer. Australia,EACH,0,0,0,0,1,312.64
6969,Printer. Australia,EACH,0,0,0,0,5,312.64
7006,P Cari Label Cand,ROLL,0,0,0,0,1,0.00
7006,P Cari Label Cand,ROLL,0,0,0,0,5,0.00
7007,P Wasa Label Cand,ROLL,0,0,0,0,1,0.00
7007,P Wasa Label Cand,ROLL,0,0,0,0,5,0.00
7008,P Spicy Sauce Can,ROLL,0,0,0,0,1,0.00
7008,P Spicy Sauce Can,ROLL,0,0,0,0,5,0.00
7009,P Gari Weg,ROLL,0,0,0,0,1,7.99
7009,P Gari Weg,ROLL,0,0,0,0,5,7.99
7010,P Wasabi Weg,ROLL,0,0,0,0,1,7.99
7010,P Wasabi Weg,ROLL,0,0,0,0,5,7.99
7011,Spy Sauce Label Weg,ROLL,0,0,0,0,1,7.99
7011,Spy Sauce Label Weg,ROLL,0,0,0,0,5,7.99
7012,Vege Gyoza Bar Code,ROLL,0,0,0,0,1,5.00
7012,Vege Gyoza Bar Code,ROLL,0,0,0,0,5,5.00
7099,KARAAGE BATTER,PK,0,0,0,0,1,6.75
7099,KARAAGE BATTER,PK,0,0,0,0,5,6.75
7120,Label Prem Tuna,ROLL,0,0,0,0,1,4.80
7120,Label Prem Tuna,ROLL,0,0,0,0,5,4.80
7121,Label Aramark,ROLL,0,0,0,0,1,0.00
7121,Label Aramark,ROLL,0,0,0,0,5,0.00
7132,P. Teriyaki 250,ROLL,0,0,0,0,1,5.15
7132,P. Teriyaki 250,ROLL,0,0,0,0,5,5.15
7139,New Nutri Broch,ROLL,0,0,0,0,1,10.00
7139,New Nutri Broch,ROLL,0,0,0,0,5,10.00
7143,Lab Can Nut Fac,ROLL,0,0,0,0,1,0.00
7143,Lab Can Nut Fac,ROLL,0,0,0,0,5,0.00
7144,P Spicy Oishisa L 200,ROLL,0,0,0,0,1,7.00
7144,P Spicy Oishisa L 200,ROLL,0,0,0,0,5,7.00
7149,P Label Avery,ROLL,0,0,0,0,1,0.00
7149,P Label Avery,ROLL,0,0,0,0,5,0.00
7150,P LA Wasa Sauce,ROLL,0,0,0,0,1,0.00
7150,P LA Wasa Sauce,ROLL,0,0,0,0,5,0.00
7151,Label Swt Chili,ROLL,0,0,0,0,1,6.00
7151,Label Swt Chili,ROLL,0,0,0,0,5,6.00
7156,THERMO PF SUSHI,ROLL,0,0,0,0,1,6.06
7156,THERMO PF SUSHI,ROLL,0,0,0,0,5,6.06
7158,Lab Bar Code,ROLL,0,0,0,0,1,0.00
7158,Lab Bar Code,ROLL,0,0,0,0,5,0.00
7161,P LA Konomi 1000,EACH,0,0,0,0,1,0.00
7161,P LA Konomi 1000,EACH,0,0,0,0,5,0.00
7167,Label Kowalski,ROLL,0,0,0,0,1,0.00
7167,Label Kowalski,ROLL,0,0,0,0,5,0.00
7170,P.LA GOMA RETAIL LABEL,EACH,0,0,0,0,1,0.00
7170,P.LA GOMA RETAIL LABEL,EACH,0,0,0,0,5,0.00
7183,Label Grill Gyoza,ROLL,0,0,0,0,1,2.03
7183,Label Grill Gyoza,ROLL,0,0,0,0,5,2.03
720,LATE ORDER,EACH,0,0,0,0,1,0.00
720,LATE ORDER,EACH,0,0,0,0,5,0.00
7219,Attach Board Set,SET,0,0,0,0,1,0.00
7219,Attach Board Set,SET,0,0,0,0,5,0.00
7225,THERMO SUSHI ICHI DIRECT,ROLL,0,0,0,0,1,6.23
7225,THERMO SUSHI ICHI DIRECT,ROLL,0,0,0,0,5,6.23
7226,Thermo Fortino Brown,ROLL,0,0,0,0,1,5.90
7226,Thermo Fortino Brown,ROLL,0,0,0,0,5,5.90
7227,Thermo Fortino Blue,ROLL,0,0,0,0,1,5.96
7227,Thermo Fortino Blue,ROLL,0,0,0,0,5,5.96
7228,THERMO LABEL BIG Y 001,ROLL,0,0,0,0,1,6.09
7228,THERMO LABEL BIG Y 001,ROLL,0,0,0,0,5,6.09
7239,Clear Chef Special Dressing Sticker,ROLL,0,0,0,0,1,6.96
7239,Clear Chef Special Dressing Sticker,ROLL,0,0,0,0,5,6.96
7243,Clear Pickled Ginger Sticker,ROLL,0,0,0,0,1,15.45
7243,Clear Pickled Ginger Sticker,ROLL,0,0,0,0,5,15.45
7303,Label Heart Cake,EACH,0,0,0,0,1,0.00
7303,Label Heart Cake,EACH,0,0,0,0,5,0.00
7332,AOS Madison Label Thermo,PK,0,0,0,0,1,26.00
7332,AOS Madison Label Thermo,PK,0,0,0,0,5,26.00
7545,Retail Rice. Microwavable,CS,0,0,0,0,1,13.56
7545,Retail Rice. Microwavable,CS,0,0,0,0,5,13.56
7546,Use 7545,BOT,0,0,0,0,1,13.80
7546,Use 7545,BOT,0,0,0,0,5,13.80
8000,Poster Frame Ikea,EACH,0,0,0,0,1,1.35
8000,Poster Frame Ikea,EACH,0,0,0,0,5,1.35
8002,Blender,EACH,0,0,0,0,1,30.00
8002,Blender,EACH,0,0,0,0,5,30.00
8082,Soup Base Tonkotsu Yama 10/cs,BOT,0,0,0,0,1,15.70
8083,Soup Base Miso Yamachan 12/cs,BOT,0,0,0,0,1,11.10
8101,HOT BOWL NET,CS,28,28,0,0,1,200.00
8101,HOT BOWL NET,CS,0,0,0,0,5,200.00
8102,Cleaning Pen,EACH,223,232,9,0,1,1.09
8102,Cleaning Pen,EACH,0,0,0,0,5,1.09
8104,Calendar Set,EACH,1704,1773,69,0,1,0.00
8104,Calendar Set,EACH,0,0,0,0,5,0.00
8112,Scrub,EACH,-24,-22,2,0,1,0.46
8112,Scrub,EACH,0,0,0,0,5,0.46
8114,Brush,EACH,27,28,1,0,1,8.90
8114,Brush,EACH,0,0,0,0,5,8.90
8116,Sanitizer,EACH,0,0,0,0,1,0.00
8116,Sanitizer,EACH,0,0,0,0,5,0.00
8118,Spray Bottle,EACH,-3,-3,0,0,1,2.66
8118,Spray Bottle,EACH,0,0,0,0,5,2.66
8121,Torch. Iwatani,EACH,-1,-1,0,0,1,23.90
8121,Torch. Iwatani,EACH,0,0,0,0,5,23.90
8122,Makisu 27cm,EACH,1662,1704,42,0,1,1.16
8122,Makisu 27cm,EACH,0,0,0,0,5,1.16
8124,Makisu (S),EACH,-15,149,164,0,1,0.94
8124,Makisu (S),EACH,0,0,0,0,5,0.94
8128,Masterchef Knife,EACH,547,572,25,0,1,47.42
8128,Masterchef Knife,EACH,0,0,0,0,5,47.42
8129,Ladle 2oz,EACH,0,0,0,0,1,0.00
8129,Ladle 2oz,EACH,0,0,0,0,5,0.00
8130,Sharp Storne-LG,EACH,-2,3,5,0,1,17.47
8130,Sharp Storne-LG,EACH,0,0,0,0,5,17.47
8131,MEASURING TEASPOON,EACH,476,476,0,0,1,2.79
8131,MEASURING TEASPOON,EACH,0,0,0,0,5,2.79
8134,ladle 1oz,EACH,0,0,0,0,1,1.50
8134,ladle 1oz,EACH,0,0,0,0,5,1.50
8137,Ladle 8oz,EACH,0,0,0,0,1,5.40
8137,Ladle 8oz,EACH,0,0,0,0,5,5.40
8138,Ladle 12oz,EACH,-20,-20,0,0,1,3.60
8138,Ladle 12oz,EACH,0,0,0,0,5,3.60
8139,Thermo Gun,EACH,0,0,0,0,1,0.00
8139,Thermo Gun,EACH,0,0,0,0,5,0.00
8140,Sushi Former,EACH,0,0,0,0,1,3.40
8140,Sushi Former,EACH,0,0,0,0,5,3.40
8142,Pail Lid Opener,EACH,25,31,6,0,1,1.62
8142,Pail Lid Opener,EACH,0,0,0,0,5,1.62
8144,Tweezer,EACH,3008,3014,6,0,1,2.27
8144,Tweezer,EACH,0,0,0,0,5,2.27
8146,Benriner,EACH,452,461,9,0,1,17.74
8146,Benriner,EACH,0,0,0,0,5,17.74
8148,Benriner Blade Only,EACH,919,920,1,0,1,4.64
8148,Benriner Blade Only,EACH,0,0,0,0,5,4.64
8150,Peeler,EACH,31,50,19,0,1,1.00
8150,Peeler,EACH,0,0,0,0,5,1.00
8153,Jigger,EACH,0,0,0,0,1,2.80
8153,Jigger,EACH,0,0,0,0,5,2.80
8154,Blue Sheet,EACH,152,162,10,0,1,55.01
8154,Blue Sheet,EACH,0,0,0,0,5,55.01
8155,Green Mirroe Sheet,EACH,0,0,0,0,1,85.00
8155,Green Mirroe Sheet,EACH,0,0,0,0,5,85.00
8156,Sushi Mold (kata),EACH,0,0,0,0,1,3.60
8156,Sushi Mold (kata),EACH,0,0,0,0,5,3.60
8157,Mirror Sheet W/R/Gold for Publix,EACH,0,0,0,0,1,205.00
8157,Mirror Sheet W/R/Gold for Publix,EACH,0,0,0,0,5,205.00
8158,Sunoko (Ivory) Special,CASE,0,0,0,0,1,475.00
8158,Sunoko (Ivory) Special,CASE,0,0,0,0,5,475.00
8160,Sunoko (MAT) IV,CASE,0,0,0,0,1,316.00
8160,Sunoko (MAT) IV,CASE,0,0,0,0,5,316.00
8162,Buffer Solution,EACH,1610,1747,137,1200,1,35.62
8162,Buffer Solution,EACH,0,0,0,0,5,35.62
8166,Safety Glove. Med or SM,EACH,22,22,0,0,1,6.95
8166,Safety Glove. Med or SM,EACH,0,0,0,0,5,6.95
8168,P Glove Small 100,PK,133,169,36,0,1,2.00
8168,P Glove Small 100,PK,0,0,0,0,5,2.00
8170,P Glove Medium 100,PK,-58,-29,29,1200,1,2.00
8170,P Glove Medium 100,PK,0,0,0,0,5,2.00
8172,P Glove Large 100,PK,30326,30386,60,0,1,0.61
8172,P Glove Large 100,PK,0,0,0,0,5,0.61
8174,Paper Towel,EACH,14,14,0,0,1,1.75
8174,Paper Towel,EACH,0,0,0,0,5,1.75
8176,Seal Wrap 18,EACH,-25,-22,3,0,1,21.34
8176,Seal Wrap 18,EACH,0,0,0,0,5,21.34
8178,Towel Disposable,PACK,165,171,6,0,1,14.17
8178,Towel Disposable,PACK,0,0,0,0,5,14.17
8180,Wax Paper,EACH,149,154,5,0,1,4.00
8180,Wax Paper,EACH,0,0,0,0,5,4.00
8182,Absorbent Pad  1.000pc,BOX,39,79,40,0,1,13.38
8182,Absorbent Pad  1.000pc,BOX,0,0,0,0,5,13.38
8183,Nigiri Maker,EACH,0,0,0,0,1,2.00
8183,Nigiri Maker,EACH,0,0,0,0,5,2.00
8184,Disposable Pastry Bag,EACH,451,507,56,0,1,15.00
8184,Disposable Pastry Bag,EACH,0,0,0,0,5,15.00
8186,Pastry Bag Tip,EACH,337,354,17,100,1,0.65
8186,Pastry Bag Tip,EACH,0,0,0,0,5,0.65
8190,Binder Set,EACH,0,0,0,0,1,0.00
8190,Binder Set,EACH,0,0,0,0,5,0.00
8195,Strainer,EACH,0,0,0,0,1,0.00
8195,Strainer,EACH,0,0,0,0,5,0.00
8205,Water Base Frame,EACH,9,9,0,0,1,103.00
8205,Water Base Frame,EACH,0,0,0,0,5,103.00
8210,Indoor Banner Cust. Service,EACH,0,0,0,0,1,30.00
8210,Indoor Banner Cust. Service,EACH,0,0,0,0,5,30.00
8211,A shape Panel,EACH,6,6,0,0,1,35.00
8211,A shape Panel,EACH,0,0,0,0,5,35.00
8220,Shelf Liner Cust. Service,EACH,0,0,0,0,1,10.50
8220,Shelf Liner Cust. Service,EACH,0,0,0,0,5,10.50
8225,Shelf Liner 2 Liner Cust. Service,EACH,0,0,0,0,1,15.00
8225,Shelf Liner 2 Liner Cust. Service,EACH,0,0,0,0,5,15.00
8304,Rice Warmer,EACH,0,0,0,0,1,220.65
8304,Rice Warmer,EACH,0,0,0,0,5,220.65
8306,Water Base Attachment,EACH,-27,-27,0,0,1,29.00
8306,Water Base Attachment,EACH,0,0,0,0,5,29.00
8308,Water Base Frame Bundle Set,EACH,4,5,1,30,1,183.00
8308,Water Base Frame Bundle Set,EACH,0,0,0,0,5,183.00
8312,Picture Frame  IKEA,EACH,0,0,0,0,1,2.50
8312,Picture Frame  IKEA,EACH,0,0,0,0,5,2.50
8316,A La Carte Sign,EACH,0,0,0,0,1,0.00
8316,A La Carte Sign,EACH,0,0,0,0,5,0.00
8320,Sign Holder CLP,EACH,-154,-154,0,0,1,1.38
8320,Sign Holder CLP,EACH,0,0,0,0,5,1.38
8324,Paper Clock,EACH,45,48,3,0,1,1.50
8324,Paper Clock,EACH,0,0,0,0,5,1.50
8335,Static Cling,EACH,-28,-28,0,0,1,7.50
8336,Posters - Hot Food Bundle,EACH,-107,-107,0,0,1,7.67
8336,Posters - Hot Food Bundle,EACH,0,0,0,0,5,7.67
8340,Indoor Banner. Fully Cooked,EACH,0,0,0,0,1,30.00
8340,Indoor Banner. Fully Cooked,EACH,0,0,0,0,5,30.00
8342,Chef Sp Mini Poster Small,EACH,0,0,0,0,1,1.00
8342,Chef Sp Mini Poster Small,EACH,0,0,0,0,5,1.00
8344,Letter Poster,EACH,4404,4404,0,0,1,3.00
8344,Letter Poster,EACH,0,0,0,0,5,3.00
8345,Ironman Sign & Frames,EACH,0,0,0,0,1,69.00
8345,Ironman Sign & Frames,EACH,0,0,0,0,5,69.00
8346,Poster. Placard Publix,EACH,-2166,-2166,0,0,1,4.00
8348,Indoor Banner Stand,EACH,0,0,0,0,1,25.00
8348,Indoor Banner Stand,EACH,0,0,0,0,5,25.00
8352,Hybrid Program Set,EACH,0,0,0,0,1,0.00
8352,Hybrid Program Set,EACH,0,0,0,0,5,0.00
8360,Nutrition Charts. Laminated,EACH,17,18,1,0,1,3.50
8360,Nutrition Charts. Laminated,EACH,0,0,0,0,5,3.50
8361,MDB Nutrition Chart,EACH,-2,-2,0,0,1,3.50
8361,MDB Nutrition Chart,EACH,0,0,0,0,5,3.50
8364,New Color Menu 100,SET,501,511,10,0,1,14.00
8364,New Color Menu 100,SET,0,0,0,0,5,14.00
8365,MDB Color Menu 100,EACH,-3,-3,0,0,1,17.00
8365,MDB Color Menu 100,EACH,0,0,0,0,5,17.00
8366,Color Menu. Rouses 100 Sh,EACH,202,202,0,0,1,20.00
8366,Color Menu. Rouses 100 Sh,EACH,0,0,0,0,5,20.00
8368,SAMPLING TAGS,EACH,0,0,0,0,1,9.55
8368,SAMPLING TAGS,EACH,0,0,0,0,5,9.55
8372,STAR STICKER,EACH,0,0,0,0,1,1.00
8372,STAR STICKER,EACH,0,0,0,0,5,1.00
8384,Pull up Banner,EACH,0,0,0,0,1,250.00
8384,Pull up Banner,EACH,0,0,0,0,5,250.00
8500,Curry Kettle Warmer,EACH,0,0,0,0,1,65.00
8500,Curry Kettle Warmer,EACH,0,0,0,0,5,65.00
8504,Sesame Shaker,EACH,144,151,7,0,1,3.42
8504,Sesame Shaker,EACH,0,0,0,0,5,3.42
8508,To Go Soy Cont.,EACH,369,369,0,0,1,2.15
8508,To Go Soy Cont.,EACH,0,0,0,0,5,2.15
8512,Yosenabe Pot,EACH,1,2,1,0,1,25.99
8512,Yosenabe Pot,EACH,0,0,0,0,5,25.99
8516,Menu Holder,EACH,68,71,3,0,1,27.50
8516,Menu Holder,EACH,0,0,0,0,5,27.50
8520,Fish Container Body,EACH,317,336,19,0,1,4.56
8520,Fish Container Body,EACH,0,0,0,0,5,4.56
8524,Fish Container Top,EACH,304,332,28,0,1,2.73
8524,Fish Container Top,EACH,0,0,0,0,5,2.73
8528,Food Container (S) Body,EACH,240,252,12,0,1,3.75
8528,Food Container (S) Body,EACH,0,0,0,0,5,3.75
8532,Food Cont (S) Lid,EACH,226,239,13,0,1,2.83
8532,Food Cont (S) Lid,EACH,0,0,0,0,5,2.83
8536,Food Cont (L) BD,EACH,141,153,12,0,1,5.36
8536,Food Cont (L) BD,EACH,0,0,0,0,5,5.36
8540,Food Cont (L) LD,EACH,201,219,18,0,1,3.16
8540,Food Cont (L) LD,EACH,0,0,0,0,5,3.16
8544,Food Cont (XL) BD,EACH,150,171,21,0,1,7.48
8544,Food Cont (XL) BD,EACH,0,0,0,0,5,7.48
8548,Food Cont (XL) LD,EACH,203,224,21,0,1,4.76
8548,Food Cont (XL) LD,EACH,0,0,0,0,5,4.76
8552,S Rice Box Body,EACH,-63,-59,4,0,1,12.71
8552,S Rice Box Body,EACH,0,0,0,0,5,12.71
8556,S Rice Box Lid,EACH,109,113,4,0,1,7.83
8556,S Rice Box Lid,EACH,0,0,0,0,5,7.83
8560,Rice Mix Box,EACH,171,174,3,0,1,22.14
8560,Rice Mix Box,EACH,0,0,0,0,5,22.14
8564,Rice Mix Box Lid,EACH,201,206,5,0,1,13.00
8564,Rice Mix Box Lid,EACH,0,0,0,0,5,13.00
8568,Rice Bin,EACH,77,79,2,0,1,28.89
8568,Rice Bin,EACH,0,0,0,0,5,28.89
8572,Rice Scoop,EACH,97,100,3,15,1,7.95
8572,Rice Scoop,EACH,0,0,0,0,5,7.95
8576,Rice Spatula,EACH,25,29,4,0,1,3.70
8576,Rice Spatula,EACH,0,0,0,0,5,3.70
8580,Tong 12in,EACH,0,0,0,0,1,3.85
8580,Tong 12in,EACH,0,0,0,0,5,3.85
8584,Measure Cup 1qt,EACH,-28,-22,6,0,1,7.15
8584,Measure Cup 1qt,EACH,0,0,0,0,5,7.15
8588,Sauce Bottle,EACH,239,251,12,0,1,0.86
8588,Sauce Bottle,EACH,0,0,0,0,5,0.86
8600,Bluetooth Adapter,EACH,0,0,0,0,1,103.15
8600,Bluetooth Adapter,EACH,0,0,0,0,5,103.15
8704,Temp Recorder UTRIX-16,EACH,0,0,0,0,1,28.00
8704,Temp Recorder UTRIX-16,EACH,0,0,0,0,5,28.00
8705,PH Tester,EACH,-2,2,4,0,1,79.99
8705,PH Tester,EACH,0,0,0,0,5,79.99
8710,PH Replacment Tip,EACH,-4,-3,1,0,1,40.50
8710,PH Replacment Tip,EACH,0,0,0,0,5,40.50
8712,PH Tester Paper,EACH,80,85,5,0,1,11.88
8712,PH Tester Paper,EACH,0,0,0,0,5,11.88
8714,Tablet. Hot Spare,EACH,0,0,0,0,1,489.00
8714,Tablet. Hot Spare,EACH,0,0,0,0,5,489.00
8715,Label Machine,EACH,0,0,0,0,1,740.00
8715,Label Machine,EACH,0,0,0,0,5,740.00
8716,Tablet Bundle 2 TRI,EACH,0,0,0,0,1,748.00
8716,Tablet Bundle 2 TRI,EACH,0,0,0,0,5,748.00
8717,Tablets Bundle 1 TRI,EACH,0,0,0,0,1,984.00
8717,Tablets Bundle 1 TRI,EACH,0,0,0,0,5,984.00
8718,Tablet Outer Case,EACH,0,0,0,0,1,35.00
8718,Tablet Outer Case,EACH,0,0,0,0,5,35.00
8719,Zebra Printer LP2824,EACH,0,0,0,0,1,450.00
8719,Zebra Printer LP2824,EACH,0,0,0,0,5,450.00
8720,Scanner,EACH,0,0,0,0,1,388.25
8720,Scanner,EACH,0,0,0,0,5,388.25
8721,Tablet Bundle 1 WTP,EACH,16,17,1,0,1,798.95
8721,Tablet Bundle 1 WTP,EACH,0,0,0,0,5,798.95
8722,Tablet Bundle 2 WTP,EACH,-1,-1,0,0,1,365.00
8722,Tablet Bundle 2 WTP,EACH,0,0,0,0,5,365.00
8735,Scan Sheet Single,EACH,0,0,0,0,1,5.00
8735,Scan Sheet Single,EACH,0,0,0,0,5,5.00
8740,Scan Sheet Hap Heart,EACH,0,0,0,0,1,3.00
8740,Scan Sheet Hap Heart,EACH,0,0,0,0,5,3.00
8750,Thermometer  Digital,EACH,176,183,7,0,1,21.50
8750,Thermometer  Digital,EACH,0,0,0,0,5,21.50
8755,Rice Cooker,EACH,48,60,12,0,1,143.90
8755,Rice Cooker,EACH,0,0,0,0,5,143.90
8760,R Cook Inr. Pot,EACH,1,9,8,0,1,79.60
8760,R Cook Inr. Pot,EACH,0,0,0,0,5,79.60
8765,Rice Cooker Top,EACH,44,45,1,0,1,38.30
8765,Rice Cooker Top,EACH,0,0,0,0,5,38.30
8770,Digital Picture Frame,EACH,0,0,0,0,1,150.00
8770,Digital Picture Frame,EACH,0,0,0,0,5,150.00
8775,Date Gun,EACH,8,16,8,150,1,67.00
8775,Date Gun,EACH,0,0,0,0,5,67.00
8780,Steamer. Dumpling,EACH,0,0,0,0,1,10.00
8780,Steamer. Dumpling,EACH,0,0,0,0,5,10.00
8902,HK Happi Coat & Hat,SET,0,0,0,0,1,56.50
8902,HK Happi Coat & Hat,SET,0,0,0,0,5,56.50
8904,Chef Coat White Small,EACH,165,173,8,150,1,20.20
8904,Chef Coat White Small,EACH,0,0,0,0,5,20.20
8905,Chef Coat White Medium,EACH,324,351,27,0,1,20.20
8905,Chef Coat White Medium,EACH,0,0,0,0,5,20.20
8906,Chef Coat White Lg,EACH,182,182,0,0,1,20.20
8906,Chef Coat White Lg,EACH,0,0,0,0,5,20.20
8907,Chef Coat White XL,EACH,201,201,0,0,1,20.20
8907,Chef Coat White XL,EACH,0,0,0,0,5,20.20
8910,Chef Coat Black,EACH,232,232,0,0,1,23.00
8910,Chef Coat Black,EACH,0,0,0,0,5,23.00
8911,Chef Coat. Black.Coastal Pacific,EACH,0,0,0,0,1,26.00
8911,Chef Coat. Black.Coastal Pacific,EACH,0,0,0,0,5,26.00
8915,Chef Coat Harris-Teeter,EACH,-7,-7,0,0,1,32.45
8915,Chef Coat Harris-Teeter,EACH,0,0,0,0,5,32.45
8920,Chef Coat Metropolitan,EACH,55,55,0,0,1,23.00
8920,Chef Coat Metropolitan,EACH,0,0,0,0,5,23.00
8925,Chef Coat Red,EACH,788,793,5,0,1,29.30
8925,Chef Coat Red,EACH,0,0,0,0,5,29.30
8930,Chef Coat Yamato,EACH,123,123,0,10,1,34.20
8930,Chef Coat Yamato,EACH,0,0,0,0,5,34.20
8931,Wild Blue Chef Coat Sm,EACH,-1,-1,0,0,1,41.00
8932,Wild Blue Chef Coat Med,EACH,0,0,0,0,1,41.00
8933,Wild Blue Chef Coat Lrg,EACH,-2,-2,0,0,1,41.00
8934,Wild Blue Chef Coat XL,EACH,0,0,0,0,1,41.00
8935,Happi Coat Red Giant Eagle,EACH,0,0,0,0,1,45.00
8935,Happi Coat Red Giant Eagle,EACH,0,0,0,0,5,45.00
8940,Chef Coat Rouses,EACH,227,227,0,0,1,25.00
8940,Chef Coat Rouses,EACH,0,0,0,0,5,25.00
8943,Chef Coat Green Small,EACH,234,235,1,0,1,29.30
8943,Chef Coat Green Small,EACH,0,0,0,0,5,29.30
8944,Chef Coat Green Medium,EACH,183,192,9,0,1,29.30
8944,Chef Coat Green Medium,EACH,0,0,0,0,5,29.30
8945,Chef Coat Green Large,EACH,100,102,2,0,1,29.30
8945,Chef Coat Green Large,EACH,0,0,0,0,5,29.30
8950,Polo Shirts White,EACH,2152,2155,3,0,1,18.00
8950,Polo Shirts White,EACH,0,0,0,0,5,18.00
8954,Apron Black,EACH,165,171,6,0,1,7.75
8954,Apron Black,EACH,0,0,0,0,5,7.75
8958,Hat Black (M),EACH,547,563,16,0,1,5.80
8958,Hat Black (M),EACH,0,0,0,0,5,5.80
8959,HAT RED DEMO,EACH,227,228,1,0,1,9.00
8959,HAT RED DEMO,EACH,0,0,0,0,5,9.00
8962,HOT FOOD BASEBALL CAP,EACH,309,320,11,0,1,5.00
8962,HOT FOOD BASEBALL CAP,EACH,0,0,0,0,5,5.00
8966,Name Badge,EACH,239,247,8,0,1,2.50
8966,Name Badge,EACH,0,0,0,0,5,2.50
9051,Hat White S.M.L,EACH,-16,-16,0,0,1,5.75
9051,Hat White S.M.L,EACH,0,0,0,0,5,5.75
9099,Happi White (S),EACH,0,0,0,0,1,17.00
9099,Happi White (S),EACH,0,0,0,0,5,17.00
9100,Happi White (M),EACH,0,0,0,0,1,17.00
9100,Happi White (M),EACH,0,0,0,0,5,17.00
9101,Happi White (L),EACH,0,0,0,0,1,22.00
9101,Happi White (L),EACH,0,0,0,0,5,22.00
9102,Happi White (XL),EACH,0,0,0,0,1,15.50
9102,Happi White (XL),EACH,0,0,0,0,5,15.50
9103,Happi Hat Whi S,EACH,0,0,0,0,1,0.00
9103,Happi Hat Whi S,EACH,0,0,0,0,5,0.00
9104,Happi Apron Grn,EACH,0,0,0,0,1,8.50
9104,Happi Apron Grn,EACH,0,0,0,0,5,8.50
9107,Happi Hat (M),EACH,0,0,0,0,1,0.00
9107,Happi Hat (M),EACH,0,0,0,0,5,0.00
9108,Happi Hat (L),EACH,0,0,0,0,1,0.00
9108,Happi Hat (L),EACH,0,0,0,0,5,0.00
9109,Happi Blue SMLX,EACH,0,0,0,0,1,0.00
9109,Happi Blue SMLX,EACH,0,0,0,0,5,0.00
9110,Happi Blue LG,EACH,0,0,0,0,1,17.00
9110,Happi Blue LG,EACH,0,0,0,0,5,17.00
9111,Happi Blue SM,EACH,0,0,0,0,1,17.00
9111,Happi Blue SM,EACH,0,0,0,0,5,17.00
9112,Happi Blue M,EACH,0,0,0,0,1,0.00
9112,Happi Blue M,EACH,0,0,0,0,5,0.00
9113,Happi Blue XLG,EACH,0,0,0,0,1,17.00
9113,Happi Blue XLG,EACH,0,0,0,0,5,17.00
9114,Happi Hat Blue,EACH,0,0,0,0,1,6.00
9114,Happi Hat Blue,EACH,0,0,0,0,5,6.00
9117,Happi Gold SML,EACH,0,0,0,0,1,0.00
9117,Happi Gold SML,EACH,0,0,0,0,5,0.00
9118,Happi Gold M,EACH,0,0,0,0,1,21.50
9118,Happi Gold M,EACH,0,0,0,0,5,21.50
9119,Happi Gold LG,EACH,0,0,0,0,1,21.50
9119,Happi Gold LG,EACH,0,0,0,0,5,21.50
9120,Navy Chef Jacket,EACH,0,0,0,0,1,29.25
9120,Navy Chef Jacket,EACH,0,0,0,0,5,29.25
9122,Hat Black (S),EACH,-130,-125,5,0,1,6.00
9122,Hat Black (S),EACH,0,0,0,0,5,6.00
9124,Hat Black (L),EACH,-202,-202,0,0,1,6.00
9124,Hat Black (L),EACH,0,0,0,0,5,6.00
9125,Happi Gold XSML,EACH,0,0,0,0,1,21.50
9125,Happi Gold XSML,EACH,0,0,0,0,5,21.50
9126,Hapi Oishisa SM,EACH,0,0,0,0,1,20.00
9126,Hapi Oishisa SM,EACH,0,0,0,0,5,20.00
9127,Hapi Oishisa M,EACH,0,0,0,0,1,0.00
9127,Hapi Oishisa M,EACH,0,0,0,0,5,0.00
9128,Hapi Oishisa L,EACH,0,0,0,0,1,20.00
9128,Hapi Oishisa L,EACH,0,0,0,0,5,20.00
9129,Hapi Oishisa XL,EACH,0,0,0,0,1,20.00
9129,Hapi Oishisa XL,EACH,0,0,0,0,5,20.00
9130,Hapi Wegman SM,EACH,0,0,0,0,1,13.50
9130,Hapi Wegman SM,EACH,0,0,0,0,5,13.50
9131,Hapi Wegman M,EACH,0,0,0,0,1,13.50
9131,Hapi Wegman M,EACH,0,0,0,0,5,13.50
9132,Hapi Wegman L,EACH,0,0,0,0,1,13.50
9132,Hapi Wegman L,EACH,0,0,0,0,5,13.50
9133,Hapi Wegman XL,EACH,0,0,0,0,1,13.50
9133,Hapi Wegman XL,EACH,0,0,0,0,5,13.50
9135,Happi HT M,EACH,0,0,0,0,1,32.00
9135,Happi HT M,EACH,0,0,0,0,5,32.00
9136,Happi HT L,EACH,0,0,0,0,1,32.00
9136,Happi HT L,EACH,0,0,0,0,5,32.00
9137,Hat HT M,EACH,0,0,0,0,1,7.00
9137,Hat HT M,EACH,0,0,0,0,5,7.00
9138,Hat HT L,EACH,0,0,0,0,1,7.00
9138,Hat HT L,EACH,0,0,0,0,5,7.00
9139,Happi HT SM,EACH,0,0,0,0,1,13.50
9139,Happi HT SM,EACH,0,0,0,0,5,13.50
9140,Happi HT XLG,EACH,0,0,0,0,1,32.00
9140,Happi HT XLG,EACH,0,0,0,0,5,32.00
9150,CHEF COAT UNITED,EACH,42,42,0,0,1,29.30
9150,CHEF COAT UNITED,EACH,0,0,0,0,5,29.30
9151,Sweatshirt. Blk,EACH,0,0,0,0,1,17.50
9151,Sweatshirt. Blk,EACH,0,0,0,0,5,17.50
9154,Ninja Apron,EACH,0,0,0,0,1,8.50
9154,Ninja Apron,EACH,0,0,0,0,5,8.50
9165,Chef Coat Weg,EACH,0,0,0,0,1,20.20
9165,Chef Coat Weg,EACH,0,0,0,0,5,20.20
9166,Chef Coat Marsh Black,EACH,58,58,0,0,1,26.00
9166,Chef Coat Marsh Black,EACH,0,0,0,0,5,26.00
9171,Chef Coat Fortinos,PK,117,117,0,0,1,20.20
9171,Chef Coat Fortinos,PK,0,0,0,0,5,20.20
9199,Shelf Molding,EACH,0,0,0,0,1,5.00
9199,Shelf Molding,EACH,0,0,0,0,5,5.00
9200,Menu Grill Bar,EACH,0,0,0,0,1,0.00
9200,Menu Grill Bar,EACH,0,0,0,0,5,0.00
9222,Cap. Steam Table,EACH,-4,-4,0,0,1,5.00
9222,Cap. Steam Table,EACH,0,0,0,0,5,5.00
9223,Apron Steam Table,EACH,0,0,0,0,1,12.00
9223,Apron Steam Table,EACH,0,0,0,0,5,12.00
9224,T-Shirt. Black Steam Table,EACH,-17,-17,0,0,1,5.00
9224,T-Shirt. Black Steam Table,EACH,0,0,0,0,5,5.00
9225,T-Shirt. Green,EACH,-4,-4,0,0,1,5.00
9225,T-Shirt. Green,EACH,0,0,0,0,5,5.00
9252,Rice Cooker/Warmer 20 cup,EACH,0,0,0,0,1,255.00
9252,Rice Cooker/Warmer 20 cup,EACH,0,0,0,0,5,255.00
9399,Chopstick Color,EACH,0,0,0,0,1,143.90
9399,Chopstick Color,EACH,0,0,0,0,5,143.90
9400,USB Picture Drive,EACH,0,0,0,0,1,5.79
9400,USB Picture Drive,EACH,0,0,0,0,5,5.79
9440,944 HC Comp Tray,CS,0,0,0,0,1,39.08
9440,944 HC Comp Tray,CS,0,0,0,0,5,39.08
9500,Miso Soup Base,CS,0,0,0,0,1,35.96
9500,Miso Soup Base,CS,0,0,0,0,5,35.96
9799,Sushi Robot SVR-NYA,EACH,0,0,0,0,1,12250.00
9799,Sushi Robot SVR-NYA,EACH,0,0,0,0,5,12250.00
9802,Scanner Cable,EACH,0,0,0,0,1,99.00
9802,Scanner Cable,EACH,0,0,0,0,5,99.00
9803,SCA Pow Supply,EACH,0,0,0,0,1,45.37
9803,SCA Pow Supply,EACH,0,0,0,0,5,45.37
9804,PRI Power Supply,EACH,0,0,0,0,1,80.00
9804,PRI Power Supply,EACH,0,0,0,0,5,80.00
9898,Aluminum Mat. Hot FD,EACH,0,0,0,0,1,10.00
9898,Aluminum Mat. Hot FD,EACH,0,0,0,0,5,10.00
9899,Fake Ice Disp Set,EACH,0,0,0,0,1,0.01
9899,Fake Ice Disp Set,EACH,0,0,0,0,5,0.01
9900,U-Boat Utility Cart,EACH,0,0,0,0,1,241.25
9900,U-Boat Utility Cart,EACH,0,0,0,0,5,241.25
9901,Demo Table. Origami,EACH,0,0,0,0,1,120.00
9901,Demo Table. Origami,EACH,0,0,0,0,5,120.00
9902,Retractable Banner GO,EACH,0,0,0,0,1,308.00
9902,Retractable Banner GO,EACH,0,0,0,0,5,308.00
9913,Price Menu 200,EACH,0,0,0,0,1,5.00
9913,Price Menu 200,EACH,0,0,0,0,5,5.00
9916,Promotion Poster. Sticker 191167,SET,0,0,0,0,1,23.12
9916,Promotion Poster. Sticker 191167,SET,0,0,0,0,5,23.12
9940,JFC Sushi Tray 0.8 (AFC235)  Set Case,CS,0,0,0,0,1,127.00
9941,JFC Sushi Tray 1.0 (AFC-4) Set Case,CS,0,0,0,0,1,165.00
9942,JFC Sushi Tray 1.5 (AFC-5) Set Case,CS,0,0,0,0,1,147.00
9943,JFC Sushi Tray 2.0 (AFC-30) Set Cs,CS,0,0,0,0,1,132.00
9944,JFC Sushi TraySF27 (AFC-20) Set Cs,CS,0,0,0,0,1,157.00
9950,Waterbase Frame 204245,EACH,0,0,0,0,1,186.00
9950,Waterbase Frame 204245,EACH,0,0,0,0,5,186.00
9951,Waterbase Graphic Panel 195582,EACH,0,0,0,0,1,32.00
9951,Waterbase Graphic Panel 195582,EACH,0,0,0,0,5,32.00
9952,Sushi Combo Sticker 203630,EACH,0,0,0,0,1,55.50
9952,Sushi Combo Sticker 203630,EACH,0,0,0,0,5,55.50
9953,$5 Sushi Friday 203347,EACH,-46,-46,0,0,1,32.50
9953,$5 Sushi Friday 203347,EACH,0,0,0,0,5,32.50
9954,Customer Appreciation Letter 202797,EACH,-136,-136,0,0,1,5.54
9954,Customer Appreciation Letter 202797,EACH,0,0,0,0,5,5.54
9955,Deluxe Hot Bowl Sign 204873,EACH,-12,-12,0,0,1,28.00
9955,Deluxe Hot Bowl Sign 204873,EACH,0,0,0,0,5,28.00
9956,Hawaiian Poke Bowl Sign 205409,EACH,-66,-66,0,0,1,8.91
9956,Hawaiian Poke Bowl Sign 205409,EACH,0,0,0,0,5,8.91
9958,10% Off Dum W/Card,EACH,0,0,0,0,1,0.90
9958,10% Off Dum W/Card,EACH,0,0,0,0,5,0.90
9959,Sup Bowl. Valen Static Cling 200097,EACH,0,0,0,0,1,24.92
9959,Sup Bowl. Valen Static Cling 200097,EACH,0,0,0,0,5,24.92
9960,Hot Food Cat Poster 200239,EACH,0,0,0,0,1,6.00
9960,Hot Food Cat Poster 200239,EACH,0,0,0,0,5,6.00
9987,UPC Scan Book Full Set,EACH,0,0,0,0,1,30.00
9987,UPC Scan Book Full Set,EACH,0,0,0,0,5,30.00
9992,Disposable Face Mask 50pcs/box,BOX,1186,1199,13,0,1,25.00
9993,Hair Net for Kitchen,PK,-4,-4,0,0,1,31.00
9993,Hair Net for Kitchen,PK,0,0,0,0,5,31.00
9994,Sanitizer for Kitchen,EACH,0,0,0,0,1,10.00
9995,Dish Soap for Kitchen,EACH,0,0,0,0,1,4.50
9995,Dish Soap for Kitchen,EACH,0,0,0,0,5,4.50
9997,SHIPPING & HANDLING,EACH,-12,-12,0,0,1,6.00
9997,SHIPPING & HANDLING,EACH,0,0,0,0,5,6.00
9998,WT Invoice No Tax,EACH,12,12,0,0,1,13.00
9998,WT Invoice No Tax,EACH,0,0,0,0,5,13.00
9999,15% OFF STICKERS,EACH,212,212,0,0,1,3.00
9999,15% OFF STICKERS,EACH,0,0,0,0,5,3.00
