Item,Description,UOM,Available,OnHand,Allocated,OnOrder,WHS,Cost
2201,Amberjack (Yellowtail)  11 lbs,LBS,209,220,11,0,2,133.32
2203,Tuna-AA  11#/BX,CS,0,0,0,0,2,93.75
2204,Tuna-A   (22),LBS,1386,3344,1958,0,2,167.20
2207,Albacore 22lbs.,CS,36,36,0,0,2,181.50
2209,Tuna C-Tatakimi 22lbs,LBS,1474,3476,2002,0,2,147.40
2210,MSC Tuna A,LBS,0,0,0,0,2,187.00
2211,MSC Albacore 22,CS,102,107,5,0,2,181.50
2212,Tuna w/ skin,LBS,0,0,0,0,2,174.90
2216,Tuna Tray,TRAY,420,420,0,0,2,226.80
2232,Smoked Atlantic  Salmon   (24),LBS,1056,1296,240,0,2,248.40
2236,Atlantic Salmon 22,LBS,0,0,0,0,2,145.20
2237,ASC Atlantic Salmon,LBS,4202,8316,4114,0,2,145.20
2238,Pre Cut Atlantic Salmon 10/CS,LBS,0,0,0,0,2,71.00
2240,Salmon with Skin,LBS,88,176,88,0,2,135.30
2244,Salmon.Grilled  Coho Roast Fzn. 22/CS,CS,117,144,27,0,2,199.82
2252,Fresh Water Eel   (11),LBS,77,77,0,0,2,183.37
2259,Unakaba. Imitation Eel 4/24/CS,PK,5184,5568,384,0,2,18.72
2406,Shrimp Tray Vannamei 20tray/CS,TRAY,740,1560,820,0,2,108.40
2418,Tempura Shrimp 10Pc 15tray/CS,TRAY,795,2265,1470,0,2,49.05
2436,Baby Shrimp 5 lbs 4bag/CS,BAG,324,732,408,0,2,112.00
2440,Crab Stick Imi  H.G. CS16,PK,4320,9520,5200,13440,2,65.92
2441,Crab Flake Imi  H.G.CS16,PK,0,0,0,0,2,61.44
2442,AFC Crab Shredded CS16,PK,1040,2704,1664,4800,2,63.20
2443,Crab Stick India CS16,PACK,0,0,0,0,2,62.72
2444,Natural Imitation Crab Stick,CS,0,0,0,0,2,61.77
2451,Imi Crab Flake Kosher,CS,0,0,0,0,2,55.00
2466,Real Crab   (5) 25lb/CS,lb,25,100,75,0,2,206.25
2472,Kosh Imit Crab Stick 12/1lbs,CS,6,10,4,0,2,65.00
2605,Fried Tofu Cubes 10 x 2.2lbs,CASE,16,18,2,0,2,62.50
2606,Natural Tempura Crispy 6bag/CS,BAG,192,372,180,0,2,43.50
2619,Fish Roe Masago 4.4 lbs  4/CS,PK,60,84,24,0,2,126.00
2625,Fish Roe Masago 0.44 lbs. 30pk/cs,PK,1800,2040,240,0,2,84.00
2630,Tobiko Red  12/1.1 lbs/CS,PK,324,360,36,0,2,150.00
2642,Mushroom  1.1 lbs 10/CS,PK,0,0,0,0,2,45.00
2648,Gourd 2.2LB 10/CS,PK,0,0,0,0,2,90.00
2654,Carrot 2.2 lbs 6/CS,PK,0,0,0,0,2,21.00
2660,Edamame Beans 10/2lbs,BAG,1520,1570,50,0,2,31.30
2666,Egg Cake 20/CS,EACH,-40,0,40,0,2,18.75
2672,Seabreeze Salad  24/1.1  LBS/CS,EACH,888,2136,1248,0,2,90.48
2678,Calamari Salad  24/1.1 lbs/CS,EACH,-264,216,480,0,2,120.96
2682,AFC Fusion Spicy Sauce,CASE,0,0,0,0,2,45.20
27,PALLET,EACH,0,0,0,0,2,7.50
2805,Grilled Chicken 2/5lb/CS,BAG,188,196,8,0,2,32.00
2810,Grilled Dumpling Shrimp 30/CS,BAG,2580,4770,2190,0,2,117.00
2817,Chicken Gyoza Mushroom (ORANGE) 10/49pc,CS,0,0,0,0,2,46.80
2818,Chicken Gyoza  Leek (WHITE) 10/49pc,CS,0,0,0,0,2,46.80
2819,Pre Fried Spring Roll 200pc/CS,CS,78,104,26,0,2,45.00
2820,Shumai 104P/CS,CS,0,0,0,0,2,25.85
2821,Pork Shumai 108pc/CS,CS,37,61,24,0,2,26.20
2822,AFC Sukiyaki Beef 12/1lbs,CS,6,6,0,0,2,55.20
2824,Chicken Katsu 30lb/CS,CS,0,0,0,0,2,101.40
2826,Asian BBQ Beef 30#,CS,28,55,27,0,2,131.70
2827,Yakiniku  Beef  10/2.2lb,CS,0,0,0,0,2,73.20
2828,Diced Pastrami  4BAG/CS,BAG,0,0,0,0,2,65.52
2829,Japanese Meatball 10pk/cs,CS,0,0,0,0,2,63.80
2831,Crispy Chicken (Karaage) 30#/CS,CS,61,234,173,0,2,67.20
2835,#3 Teriyaki Chicken 5x5.28 lbs bag,BAG,0,0,0,0,2,80.50
2836,#3 Teriyaki Chicken OH,CS,75,169,94,0,2,107.10
2837,Chicken Skewers (Yakitori) 20bags/cs,CS,113,142,29,0,2,86.00
2840,#6 Chicken Breast 10 lbs/CS,CS,25,32,7,0,2,42.75
2843,Pork Chashu  8LBS/CS,CS,11,11,0,0,2,74.27
2845,UDON. SANUKI 8/2.75lbs,CS,6,6,0,0,2,20.80
2846,Chicken Chashu w/Soy 20/1lbs,CASE,0,0,0,0,2,89.87
2847,AFC Tonkotsu Ramen  w/Vegetables  50pc/6oz,CASE,0,0,0,0,2,115.00
2855,Yakisoba. JSL  Fzn Noodles 5/4lbs,CS,57,78,21,0,2,18.67
2861,Fzn Ramen Noodles. MTC 40pc,CS,20,20,0,0,2,27.20
2862,Ramen Yamachan 40pc/cs,CS,0,0,0,0,2,20.80
2865,INARI PACK 30 pc 20/CS,PACK,400,540,140,0,2,56.20
2870,Natural Inari 10/60pc,PK,0,0,0,0,2,55.30
2875,Classic Yummy Sauce 4/Gal/CS,BOT,0,0,0,0,2,86.52
2876,Yuzu Sauce 10/per Cs,BOT,0,0,0,0,2,200.00
2877,Vegetable Curry CS50,CS,0,0,0,0,2,46.19
2885,Fzn AFC Goma Sesame Dressing 12/kg Otafu,PK,0,0,0,0,2,42.00
2999,Waygu,CS,0,0,0,0,2,102.96
3205,Ginger A 20LB,EACH,24,34,10,0,2,29.00
3210,Ginger B 20LB,EACH,43,103,60,0,2,30.00
3215,Wasabi 2.2lb,PK,595,1277,682,0,2,3.94
3220,Seaweed Nori 200 1/2SH,BAG,5480,7200,1720,0,2,310.80
3235,Soy Sauce L/S 1000 pc,CS,427,599,172,0,2,15.02
3236,Wild Blue Soy Sauce L/S 1000pc,CS,0,0,0,0,2,19.89
3240,Soy Sauce Special IZU,CS,0,0,0,0,2,15.40
3245,PREMIUM RICE 40 lbs,BAG,1022,1275,253,2100,2,16.00
3246,AFC Brown Rice  40#,BAG,51,108,57,0,2,16.52
3253,SPECIAL Military Brown Rice,BAG,4,4,0,0,2,30.05
3256,Vinegar  H-100 Natural 5.28gal,CS,153,293,140,0,2,26.02
3265,Sesame Seeds 5LB,BAG,36,146,110,0,2,10.55
3270,Sesame Seed Blk 8oz,BOT,314,383,69,0,2,2.46
3280,Tapioca (Spring Roll Wrap) Paper 50pc,EACH,383,610,227,0,2,29.10
3289,Fried Onion,EACH,0,0,0,0,2,36.00
3290,Fried Onions 10/1kg,EACH,380,1620,1240,0,2,26.00
3403,Kikk Sushi Sauce  0.5 gal,BOT,0,0,0,0,2,6.92
3404,Sushi Sauce Case  4/gal,BOT,284,576,292,0,2,55.96
3406,Kik Ponzu Sauce 500pc,CS,130,136,6,0,2,14.18
3409,Wasabi Sauce 0.5G,BOT,65,76,11,0,2,9.43
3412,Premium Spicy Sauce 0.5G,BOT,93,209,116,0,2,11.65
3415,Hot Garlic Sauce,BOT,-14,0,14,0,2,16.50
3418,Sweet  Chili SA 200,CS,-13,46,59,0,2,21.46
3419,Chili Oil for Sushi,CS,0,0,0,0,2,35.94
3420,Chili Oil for Hot Food,CS,0,0,0,0,2,32.56
3424,Spicy Sesame Oil,BOT,4,18,14,0,2,14.70
3427,Sriracha L 28oz,BOT,504,606,102,0,2,2.13
3429,Katsu Sauce 6/cs,BOT,0,0,0,0,2,6.20
3430,**AFC Basic Sauce,CS,17,21,4,0,2,25.32
3432,Chicken Bouillon Powder,CS,0,0,0,0,2,27.30
3433,**AFC Orange Sauce,CS,26,57,31,0,2,23.52
3435,**AFC Sesame Sauce,CS,18,48,30,0,2,23.55
3436,**AFC Stir Fry Sauce,CS,-13,3,16,0,2,24.00
3437,**Sweet & Sour Sauce,BOT,0,16,16,0,2,5.73
3438,**AFC Yakiniku Sauce,BOT,16,32,16,0,2,12.63
3439,Micro Noodle Bowl 38oz,CS,0,0,0,0,2,43.32
3440,Mushroom Bouillon Powder 12/CS,EACH,0,0,0,0,2,2.21
3443,**Classic Teriyaki Sauce 12 bag/1kg,BAG,444,828,384,0,2,27.00
3445,AFC Sweet & Spicy Dipping Sauce,CS,16,17,1,0,2,47.20
3447,AFC Spicy Bomb Sauce,CASE,-1,0,1,0,2,52.00
3448,Yakisoba Sauce,BOT,0,0,0,0,2,7.57
3463,Men Tsuyu  (Soup Base) 12/16oz,BOT,60,60,0,0,2,2.95
3466,Creamy Sesame Dressing 6/32oz,CS,0,0,0,0,2,40.50
3468,Chinese Style Sesame Dressing,CS,0,0,0,0,2,58.80
3485,Miso Ramen Soup 6/2kg,BOT,30,30,0,0,2,20.78
3491,Premium AFC Poke Sauce 8/720g,CS,90,100,10,0,2,69.00
3604,Retail Pickeled Ginger Calif Cup,BOT,0,0,0,0,2,7.80
3605,Sushi Gari BOT,BOT,-1164,0,1164,0,2,10.80
3610,R Sesame 4oz,BOT,3936,4392,456,0,2,8.04
3615,Grated Wasabi,EACH,20,820,800,0,2,23.40
3635,Retail Sushi Seaweed 50pk,CS,10,26,16,0,2,24.62
3640,Green Tea  24 Can,CS,13,48,35,0,2,12.25
3647,Soy Sauce Bottle,BOT,0,0,0,0,2,13.68
3648,Soy Sauce Bottle 24 cs,BOT,2064,2688,624,0,2,30.00
3650,S Vineger,BOT,0,0,0,0,2,18.72
3655,Tofu Miso Soup 24/CS,CS,68,98,30,0,2,14.10
3660,Veg. Miso Soup 24/CS,CS,14,26,12,0,2,13.81
3805,Yellow Soy Wrapper 20/10pks,CS,0,0,0,0,2,65.00
3808,Mango Chipotle Origami Wraps 50pk/cs,PACK,0,0,0,0,2,12.00
3809,Color Soy Wrap,PK,233,235,2,0,2,2.50
3810,Soy Wrap Nori White,CS,0,0,0,0,2,108.50
3820,Kosher Ginger,EACH,0,0,0,0,2,29.00
3825,Kosher Wasabi 1KG,EACH,-1,0,1,0,2,7.50
3830,Kosher Nori 12/30sh,CS,3,5,2,0,2,141.00
3840,Natural Ginger 20LB,EACH,0,0,0,0,2,30.00
3850,Natural Wasabi 2.2LB,BAG,0,0,0,0,2,5.47
3860,Natural Vin Orange 5.28gal,CS,0,0,0,0,2,30.36
3870,Beet Root Chips,BAG,0,0,0,0,2,28.25
3871,Okra Chips,BAG,0,0,0,0,2,24.55
3999,Vegetarian Oyster Sauce 4/CS,BOT,0,0,0,0,2,5.59
4192,Yamachan Ramen 40/CS,CS,0,0,0,0,2,20.80
4777,CH-82 Fold Tray,PK,0,0,0,0,2,2.55
4998,16 oz MIC Bowl Set 50 pcs,PK,0,0,0,0,2,0.00
5110,FET 1.0 Eco Tray Body 100pc,PK,0,0,0,0,2,14.00
5111,FET 1.0 Eco Tray Lid 50pc,PK,0,0,0,0,2,3.95
5115,FET  1.5 Eco Tray Body 100pc,PK,0,0,0,0,2,18.42
5116,FET-1.5 Eco Tray Lid 50pc,PK,0,0,0,0,2,4.56
5125,AFC H1 Heart Cont Body 20 PC,PK,32,179,147,0,2,6.77
5130,AFC H1 Heart Lid 20 PC,PK,69,216,147,0,2,5.31
5145,AFC-16 Clear Body,PK,-150,-21,129,0,2,2.91
5150,AFC-16 Lid  Pack,PK,-126,-1,125,0,2,2.37
5155,AFC-4 Blue Body Pack,PK,106,1450,1344,0,2,2.72
5155A,R1.0 (AFC-4) Blue Set CS 8/50pc/CS,CS,0,0,0,0,2,39.28
5155B,R1.0 (AFC-4) Blue Set PK,PK,0,0,0,0,2,4.91
5160,AFC-4 Lid  Pack,PK,933,2207,1274,0,2,2.36
5165,AFC-5 Blue Body Pack,PK,1153,1596,443,0,2,3.10
5170,AFC-5 Lid Pack,PK,1110,1589,479,0,2,2.84
5175,AFC-20 Blue Body Pack,PK,252,464,212,0,2,3.20
5175A,SK-20 Blue Set CS 6/50pc/set cs,CS,0,0,0,0,2,34.98
5175B,SK-20 (AFC-20) Set PK,PK,0,0,0,0,2,5.83
5176,AFC-20 Clear Body,PK,659,1081,422,0,2,3.14
5180,AFC-20 Lid  Pack,PK,945,1560,615,0,2,2.84
5181,AFC-20 Compostable Body,PK,0,0,0,0,2,3.77
5182,AFC-20 Compostable Lid,PK,0,0,0,0,2,6.07
5185,AFC-30 Blue Body Pack,PK,2242,2856,614,0,2,3.97
5185A,SK-30 Blue Set Cs 6/50pc/set cs,CS,0,0,0,0,2,41.34
5185B,SK-30 (AFC-30) Set PK,PK,0,0,0,0,2,6.89
5186,AFC-30 Clear Body,PK,1157,2714,1557,0,2,3.88
5190,AFC-30 Lid Pack,PK,2791,4807,2016,0,2,3.16
5191,AFC-30 Compostable Body,PK,0,0,0,0,2,4.92
5192,AFC-30 Compostable Lid,PK,0,0,0,0,2,7.75
5195,AFC-40 Blue Body Pack,PK,-124,233,357,0,2,4.79
5195A,SK-40 Blue Set CS 6/50pc/set/CS,CS,0,0,0,0,2,49.14
5195B,SK-40 (AFC-40) Set PK,PK,0,0,0,0,2,8.19
5196,AFC-40 Clear Body,PK,359,506,147,0,2,4.66
5199,AFC-40 Lid Pack,PK,-29,481,510,0,2,3.68
5200,ST-201 Manyo Body,PK,0,0,0,0,2,9.19
5201,AFC-40 Compostable Body,PK,0,0,0,0,2,6.78
5202,AFC-40 Compostable Lid,PK,0,0,0,0,2,8.98
5203,CV-11B Body (BF-18),PK,0,0,0,0,2,3.60
5204,CV-11F Lid  (BF-18),PK,0,0,0,0,2,2.25
5205,ST-201 Blue Body,PK,0,0,0,0,2,3.44
5210,ST-201 Lid Pk,PK,0,0,0,0,2,2.82
5215,ST-202 Blue Body Pack,PK,0,0,0,0,2,4.39
5220,ST-202 Lid  PACK,PK,0,0,0,0,2,3.28
5225,ST-218 MANYO BODY,PK,0,0,0,0,2,9.34
5230,ST-218 Blue Body Pk,PK,0,0,0,0,2,5.37
5235,ST-218 LID  PACK,PK,0,0,0,0,2,3.80
5240,ST-202 Manyo Body,PK,0,0,0,0,2,7.46
5245,ST-4 Blue BD 50,PK,-72,-72,0,0,2,3.06
5251,ST-4 Lid Pack  50,PK,-72,-72,0,0,2,2.40
5255,ST-4 Manyo Body,PK,0,0,0,0,2,4.34
5265,ST-5 Blue BD 50,PK,0,0,0,0,2,3.25
5270,ST-5 Lid Pack 50,PK,0,0,0,0,2,2.89
5276,ST-5 Manyo Body,PK,0,0,0,0,2,10.55
5277,MH-30.(ZX-30) Sushi Tray 50pc/Set,SET,0,0,0,0,2,9.50
5278,MH-40 (DO-3) Sushi Tray 50pc/Set,SET,0,0,0,0,2,11.25
5279,MH-35 Sushi Tray 50pc/set,SET,0,0,0,0,2,9.00
5280,MH-10 (B-011).(AFC-4) 50pc/pk,SET,0,0,0,0,2,6.25
5281,MH-15  (AFC-5)  100pc/pk,SET,0,0,0,0,2,10.50
5282,SU-CS-75 100pc/set (AFC4),SET,0,0,0,0,2,6.32
5283,JFC -18 Tray (OP-510)  50pc/set,SET,0,0,0,0,2,5.67
5284,MH-06 (20)  Tray Set,SET,0,0,0,0,2,5.65
5285,Produce Bag,EACH,0,0,0,0,2,10.00
5286,MH-50  (40) Clear Tray Set,SET,0,0,0,0,2,15.25
5287,TTM 24oz Bottom 100pc/pk(AFC4),PK,0,0,0,0,2,11.89
5288,TTM 24 oz Lid 100pc/pk (AFC4),PK,0,0,0,0,2,9.54
5289,53205 Body 100pc/pk (AFC 30),PK,0,0,0,0,2,9.00
5290,53205L-1 Lid 100pc/pk (AFC30),PK,0,0,0,0,2,9.75
5300,32oz Bowl 300pc. Sabert,CS,-1,0,1,0,2,45.90
5301,32oz Bowl Lid 300pc. Sabert,CS,-1,0,1,0,2,47.26
5302,32oz Bowl 150pc.Anchor 150pc,CS,0,0,0,0,2,34.83
5303,32oz Bowl Lid. 150pc. Anchor 150pc,CS,0,0,0,0,2,26.95
5305,BO-SC-U24 Bowl 24oz 500pc WC,CS,5,5,0,0,2,79.45
5306,BOL-CS-24 Bowl Lid 24oz 300pc WC,CS,5,5,0,0,2,46.70
5307,BG-ST-4 Compostable Body 800pc,CS,0,0,0,0,2,77.20
5308,BG-ST-4 Compostable Lid 800pc,CS,0,0,0,0,2,92.65
5309,32oz Bowl Body Stalk L014 500pc,CS,0,0,0,0,2,71.90
5310,32oz Lid Table ware DL32 200pc,CS,0,0,0,0,2,40.56
5311,24oz Bowl BG-BO24R1 500pc,CS,0,0,0,0,2,69.18
5312,24oz Lid BG-Bo24 PL 500pc,CS,0,0,0,0,2,64.20
5313,White Diamond Ramen Bowl,CS,15,15,0,0,2,55.38
5314,EP-SH2 5X7 BLK SUSHI TRAY 600PC,CS,0,0,0,0,2,96.75
5315,EP-SH3 6X9 BLK SUSHI TRAY 600PC,CS,0,0,0,0,2,137.62
5316,Anchor M612 Base,CS,0,0,0,0,2,65.50
5317,Anchor LH600 Lid,CS,0,0,0,0,2,60.90
5318,Anchor M424-B Base,CS,0,0,0,0,2,36.85
5319,Anchor LH4LD-NB Lid,CS,0,0,0,0,2,31.75
5320,Don-S Bowl 50pcs/16pks,CS,0,0,0,0,2,214.00
5321,Don-S Lid 50pcs/16pks,CS,0,0,0,0,2,144.00
5322,Sabert D300 Base 100pc/pk (AFC 5),PK,-18,-18,0,0,2,15.04
5323,Sabert D300 Lid 50pc/pk (AFC 5),PK,-36,-36,0,0,2,7.52
5324,Sabert B300N Base HT 300pc/cs,CS,-2,0,2,0,2,56.25
5325,Sabert B300N Lid HT300pc/cs,CS,-2,0,2,0,2,60.50
5410,BF-18 Salad Cont Body50pc/24/CS,PK,0,0,0,0,2,4.35
5411,BF-18 Salad Tray Lid 50pc/24/cs,PK,0,0,0,0,2,3.78
5412,AFC-18 White Body,PK,-65,120,185,0,2,3.83
5416,AFC-18 Lid  50 pcs,PK,-47,144,191,0,2,3.91
5475,KL Hana-310,PK,0,0,0,0,2,2.07
5481,B&H 16 Bowl Body Pack,PK,0,0,0,0,2,5.61
5482,B&H 16 Bowl Lid Pack,PK,0,0,0,0,2,3.25
5483,B&H 16 Bowl Middle,PK,0,0,0,0,2,2.01
55,PR TUNA10# 02/06/19,CS,0,0,0,0,2,150.00
56,ULT Tuna 12/16/20 . Manuf.Nov.. 2020,CS,0,0,0,0,2,84.54
5601,AFC-235 Party Tray Body 50pc,PK,0,0,0,0,2,15.00
5602,AFC-235 Party Tray  Lid  50pc,PK,0,0,0,0,2,12.15
5603,AFC-40L  MW Inner 50pc x 20pk,PK,0,0,0,0,2,6.29
5604,AFC-40S MW INNER 50pc x 48,PK,0,0,0,0,2,5.67
5605,AFC-235 Party Tray Body 50pc/PK,PK,123,136,13,0,2,17.95
5610,AFC-235 Party Ty Lid 50pc/PK,PK,141,160,19,0,2,14.54
5615,SF-275(SF-3) Asaoke body,PK,0,0,0,0,2,2.88
5616,AFC-275 Party Tray Body 6/50pc,PK,512,512,0,0,2,13.90
5617,AFC-275 Party Tray Lid 6/50pc,PK,304,304,0,0,2,10.70
5620,SF-275 (SF-3) Shachi Lid,PK,0,0,0,0,2,2.21
5625,SF-355 Body (SF-5),PK,74,74,0,0,2,4.48
5630,SF-355 Lid  Pack SF-5,PK,74,74,0,0,2,3.42
5635,SF-7 Oke Body,PK,17,20,3,0,2,9.54
5640,SF-7 Lid  Pack 10pc,PK,18,21,3,0,2,6.19
5645,SF-55 White Bowl Body 50pc,PK,933,1162,229,0,2,4.98
5646,SF-55 Bowl Lid 50pc,PK,932,1161,229,0,2,3.06
5647,SF-55 Inner 200pc/12pk,PK,60,60,0,0,2,9.71
5648,TO-NB24 150sets/cs (SF55),CS,0,0,0,0,2,46.65
5653,Donburi Bowl Set DB-103,SET,0,0,0,0,2,10.38
5661,Football Tray  Each 50 pc,EACH,0,0,0,0,2,0.60
57,ULT 5# 12/16/20. Manu. Nov.. 2020,CS,0,0,0,0,2,84.54
5752,White Micro Bowls 36 oz,CS,0,0,0,0,2,43.12
5805,PLA ST-4 Cont. Set 400pc,CASE,0,0,0,0,2,124.80
5810,ECO 1.5 Compostable Lid,CS,0,0,0,0,2,34.00
5811,ECO 1.5 Compostable Tray,CS,0,0,0,0,2,38.00
5812,EG 2.0 Compostable Lid,CS,0,0,0,0,2,74.69
5813,EG 2.0 Compostable Base,CS,0,0,0,0,2,89.00
5816,BF-8 Curry White Body 50pc,PACK,0,0,0,0,2,7.16
5817,BF-8 Curry Lid  50pc,PACK,0,0,0,0,2,5.51
5818,Compostable Bowl BO-SC-U24 500pc,CASE,0,0,0,0,2,79.45
5819,Compostable Lid BOL-CS-24 300pc,CASE,0,0,0,0,2,46.70
5820,COR-R20 Body Pk 8/50pc,PK,0,0,0,0,2,4.03
5822,COR-R20 Lid 8/50pc,PK,0,0,0,0,2,3.58
5823,COP-R15 Body PK 50pc,PK,-10,0,10,0,2,3.54
5824,COP-R15 Lid PK 50pc,PK,-10,0,10,0,2,3.22
5827,COP-18 Poke Bowl  Body Pk,PK,-349,-70,279,0,2,5.46
5829,COP-18 Poke Bowl  Lid  Pk,PK,-234,57,291,0,2,4.60
5830,2 oz Cup  100pc/pk,PK,-30,0,30,0,2,1.16
5835,2 oz Lid  100pc/pk,PK,-33,-3,30,0,2,1.16
5840,Cup 90MB 4 oz  50pc,PK,245,286,41,0,2,2.73
5845,Cup 90TC 4 oz Lid  50 pc,PK,245,283,38,0,2,2.43
5860,Demo Cup  20PK/CS,PK,100,100,0,0,2,2.85
5889,Sample Tray Dome,EACH,0,0,0,0,2,149.80
5999,Sampling Dome Kit,EACH,0,0,0,0,2,341.96
6110,Baran Box 1000 pcs,PK,177,375,198,0,2,0.88
6120,Chopstick 100PR,PK,1881,2901,1020,0,2,1.04
6121,Wild Blue Chopstick 40pks,PK,0,0,0,0,2,1.10
6130,Chopkstick Special 100,PK,0,0,0,0,2,1.00
6140,Edamame  Sleeve White 100pc,PK,9,13,4,0,2,17.00
6175,Towel,EACH,0,0,0,0,2,0.00
6200,Thermo  B.R. Gradient,ROLL,0,0,0,0,2,7.50
6201,White Mini Sticker,ROLL,7,7,0,0,2,12.50
6208,Thermo Vertical Blue #3,ROLL,81,1080,999,0,2,5.75
6210,Thermo Vertical Brown Rice #3,ROLL,0,0,0,0,2,5.75
6220,12024T Freshpak Bowl 300,CS,0,0,0,0,2,93.12
6221,Freshpak Bowl Lid 52032t 300pc,CS,0,0,0,0,2,62.62
6222,Vertical Label Wild Blue,ROLL,0,0,0,0,2,7.39
6248,Vertical  No Logo,ROLL,0,0,0,0,2,5.80
6258,Vert. Robert Fresh Label,ROLL,0,0,0,0,2,6.25
6261,Lab. Vertical Nob Hill,ROLL,0,0,0,0,2,7.24
6262,Lab. Vertical Raleys,ROLL,0,0,0,0,2,7.24
6263,Lab. Vertical Bel Air,ROLL,0,0,0,0,2,7.24
6266,Lab. Vertical Olo,ROLL,0,0,0,0,2,7.24
6267,Lab Vertical Oishisa,ROLL,0,0,0,0,2,7.24
6268,Lab. Vertical PRC Market 32,ROLL,0,0,0,0,2,6.25
6269,Lab. Vertical Draegers,ROLL,0,0,0,0,2,7.24
6270,Lab Vertical Rouses,ROLL,0,0,0,0,2,7.24
6271,Lab. Vert. Metropolitan,ROLL,0,0,0,0,2,7.24
6273,Lab. Vertical Walgreen (Red Grad),ROLL,0,0,0,0,2,7.24
6275,Vert. Lake View Label,ROLL,0,0,0,0,2,6.25
6285,Thermo Vertical Yamato,ROLL,63,155,92,0,2,6.25
6290,Thermo Verti Yamato Brown,ROLL,31,41,10,0,2,6.25
6291,Thermo Kosher Vert.Purple,ROLL,0,0,0,0,2,7.24
6292,Thermal Vertical Stonefish Label,ROLL,16,16,0,0,2,8.00
6293,Microwave Instructions AFC 40L Sticker,ROLL,1,1,0,0,2,8.90
6294,PUBLIX $5 WEDNESDAY STICKER,ROLL,159,188,29,0,2,6.96
6295,Sticker 3 Min. Microwave,EACH,17,17,0,0,2,4.95
6296,$5 Red Sticker,ROLL,59,140,81,0,2,4.41
6297,$5 Barcode Sticker,EACH,246,260,14,0,2,4.41
6299,$5  Red  Sticker,ROLL,0,0,0,0,2,6.00
6300,Convection Oven 1/4Sheet,EACH,0,0,0,0,2,545.00
6301,$6 Red Sticker,ROLL,0,0,0,0,2,6.00
6302,$9.99 Purple Sticker,ROLL,0,0,0,0,2,6.00
6303,50 Cent Off W/card,ROLL,0,0,0,0,2,6.00
6304,Warm Up Microwave Sticker,ROLL,332,360,28,0,2,2.66
6350,Bleach,EACH,0,0,0,0,2,0.00
6601,BOGO Sticker,ROLL,0,0,0,0,2,8.10
6603,Date Gun Label,ROLL,107,121,14,0,2,2.20
6606,Date Gun Label "Sell-By",ROLL,140,276,136,0,2,2.20
6609,"New" Sticker Yellow,ROLL,32,39,7,0,2,4.41
6612,Clear Chef Special Sticker,ROLL,-1,0,1,0,2,5.99
6615,Clear Fully Cooked Sticker,ROLL,19,20,1,0,2,5.99
6618,Clear Ginger Dressing Sticker,ROLL,0,0,0,0,2,6.96
6621,Clear Hot Garlic Sticker,EACH,0,0,0,0,2,6.96
6624,Clear Dumpling  Microwave Instruction Sticker 250 pcs,ROLL,-23,2,25,0,2,4.75
6627,Clear Spicy Sticker,ROLL,9,9,0,0,2,5.99
6629,Chef Special Sticker Red 250,ROLL,13,13,0,0,2,4.95
6633,Clear Vegatable Only Sticker,ROLL,17,18,1,0,2,5.99
6636,P. Gari Label 250 Ribbon,ROLL,3,14,11,0,2,8.67
6639,P Wasa Label 250 Ribon,ROLL,44,54,10,0,2,7.45
6642,P Spicy Sauce L 250 Ribbon,ROLL,28,44,16,0,2,7.45
6645,P Wasabi Oishisa 250,ROLL,0,0,0,0,2,7.00
6648,P Ginger Oishisa 250,ROLL,0,0,0,0,2,7.00
6649,P. Sushi Sauce  250. Clear,ROLL,21,31,10,0,2,7.45
6651,Label Friedrice,ROLL,0,0,0,0,2,5.15
6657,Classic Yummy Sauce Label,PK,-1,0,1,0,2,8.67
6666,Brown Rice Sticker Clear,EACH,4,20,16,0,2,5.67
6669,Label. Spring Gard. Sheet,EACH,0,0,0,0,2,0.20
6672,Lab Sustain Sticker,ROLL,0,0,0,0,2,6.00
6673,Gluten Free Sticker 250,ROLL,0,0,0,0,2,8.00
6675,Prep Item Label 500,ROLL,230,276,46,0,2,1.95
6676,Hot Bowl Sell By Stickers,ROLL,-7,1,8,0,2,4.75
6677,$2 Off Red Sticker,ROLL,0,0,0,0,2,6.00
6678,$1 Off Sticker,ROLL,14,14,0,0,2,6.00
6679,Weekly Special Sticker,ROLL,0,0,0,0,2,5.25
6685,Sticker. Grilled Chicken,ROLL,0,0,0,0,2,4.95
6968,Tablet. Aus. Label Machine,EACH,0,0,0,0,2,750.00
6969,Printer. Australia,EACH,0,0,0,0,2,312.64
7006,P Cari Label Cand,ROLL,0,0,0,0,2,0.00
7007,P Wasa Label Cand,ROLL,0,0,0,0,2,0.00
7008,P Spicy Sauce Can,ROLL,0,0,0,0,2,0.00
7009,P Gari Weg,ROLL,0,0,0,0,2,7.99
7010,P Wasabi Weg,ROLL,0,0,0,0,2,7.99
7011,Spy Sauce Label Weg,ROLL,0,0,0,0,2,7.99
7012,Vege Gyoza Bar Code,ROLL,0,0,0,0,2,5.00
7099,KARAAGE BATTER,PK,0,0,0,0,2,6.75
7120,Label Prem Tuna,ROLL,0,0,0,0,2,4.80
7121,Label Aramark,ROLL,0,0,0,0,2,0.00
7132,P. Teriyaki 250,ROLL,0,0,0,0,2,5.15
7139,New Nutri Broch,ROLL,0,0,0,0,2,10.00
7143,Lab Can Nut Fac,ROLL,0,0,0,0,2,0.00
7144,P Spicy Oishisa L 200,ROLL,0,0,0,0,2,7.00
7149,P Label Avery,ROLL,0,0,0,0,2,0.00
7150,P LA Wasa Sauce,ROLL,0,0,0,0,2,0.00
7151,Label Swt Chili,ROLL,0,0,0,0,2,6.00
7156,THERMO PF SUSHI,ROLL,0,0,0,0,2,6.06
7158,Lab Bar Code,ROLL,0,0,0,0,2,0.00
7161,P LA Konomi 1000,EACH,0,0,0,0,2,0.00
7167,Label Kowalski,ROLL,0,0,0,0,2,0.00
7170,P.LA GOMA RETAIL LABEL,EACH,0,0,0,0,2,0.00
7183,Label Grill Gyoza,ROLL,0,0,0,0,2,2.03
720,LATE ORDER,EACH,0,0,0,0,2,0.00
7219,Attach Board Set,SET,0,0,0,0,2,0.00
7225,THERMO SUSHI ICHI DIRECT,ROLL,0,0,0,0,2,6.23
7226,Thermo Fortino Brown,ROLL,0,0,0,0,2,5.90
7227,Thermo Fortino Blue,ROLL,0,0,0,0,2,5.96
7228,THERMO LABEL BIG Y 001,ROLL,0,0,0,0,2,6.09
7239,Clear Chef Special Dressing Sticker,ROLL,0,0,0,0,2,6.96
7243,Clear Pickled Ginger Sticker,ROLL,0,0,0,0,2,15.45
7303,Label Heart Cake,EACH,0,0,0,0,2,0.00
7332,AOS Madison Label Thermo,PK,0,0,0,0,2,26.00
7545,Retail Rice. Microwavable,CS,0,0,0,0,2,13.56
7546,Use 7545,BOT,0,0,0,0,2,13.80
8000,Poster Frame Ikea,EACH,0,0,0,0,2,1.35
8002,Blender,EACH,0,0,0,0,2,30.00
8082,Soup Base Tonkotsu Yama 10/cs,BOT,0,0,0,0,2,15.70
8083,Soup Base Miso Yamachan 12/cs,BOT,0,0,0,0,2,11.10
8101,HOT BOWL NET,CS,1,1,0,0,2,200.00
8102,Cleaning Pen,EACH,9,10,1,0,2,1.09
8104,Calendar Set,EACH,0,0,0,0,2,0.00
8112,Scrub,EACH,5,5,0,0,2,0.46
8114,Brush,EACH,6,6,0,0,2,8.90
8116,Sanitizer,EACH,0,0,0,0,2,0.00
8118,Spray Bottle,EACH,0,0,0,0,2,2.66
8121,Torch. Iwatani,EACH,0,0,0,0,2,23.90
8122,Makisu 27cm,EACH,22,30,8,0,2,1.16
8124,Makisu (S),EACH,204,215,11,0,2,0.94
8128,Masterchef Knife,EACH,13,15,2,0,2,47.42
8129,Ladle 2oz,EACH,0,0,0,0,2,0.00
8130,Sharp Storne-LG,EACH,6,6,0,0,2,17.47
8131,MEASURING TEASPOON,EACH,0,0,0,0,2,2.79
8134,ladle 1oz,EACH,0,0,0,0,2,1.50
8137,Ladle 8oz,EACH,0,0,0,0,2,5.40
8138,Ladle 12oz,EACH,0,0,0,0,2,3.60
8139,Thermo Gun,EACH,0,0,0,0,2,0.00
8140,Sushi Former,EACH,0,0,0,0,2,3.40
8142,Pail Lid Opener,EACH,13,13,0,0,2,1.62
8144,Tweezer,EACH,10,10,0,0,2,2.27
8146,Benriner,EACH,10,11,1,0,2,17.74
8148,Benriner Blade Only,EACH,27,31,4,0,2,4.64
8150,Peeler,EACH,22,30,8,0,2,1.00
8153,Jigger,EACH,0,0,0,0,2,2.80
8154,Blue Sheet,EACH,12,14,2,0,2,55.01
8155,Green Mirroe Sheet,EACH,0,0,0,0,2,85.00
8156,Sushi Mold (kata),EACH,0,0,0,0,2,3.60
8157,Mirror Sheet W/R/Gold for Publix,EACH,0,0,0,0,2,205.00
8158,Sunoko (Ivory) Special,CASE,0,0,0,0,2,475.00
8160,Sunoko (MAT) IV,CASE,0,0,0,0,2,316.00
8162,Buffer Solution,EACH,-54,-6,48,0,2,35.62
8166,Safety Glove. Med or SM,EACH,0,0,0,0,2,6.95
8168,P Glove Small 100,PK,-10,0,10,0,2,2.00
8170,P Glove Medium 100,PK,-5,0,5,0,2,2.00
8172,P Glove Large 100,PK,0,0,0,0,2,0.61
8174,Paper Towel,EACH,0,0,0,0,2,1.75
8176,Seal Wrap 18,EACH,4,5,1,0,2,21.34
8178,Towel Disposable,PACK,7,8,1,0,2,14.17
8180,Wax Paper,EACH,10,12,2,0,2,4.00
8182,Absorbent Pad  1.000pc,BOX,5,7,2,0,2,13.38
8183,Nigiri Maker,EACH,0,0,0,0,2,2.00
8184,Disposable Pastry Bag,EACH,28,44,16,0,2,15.00
8186,Pastry Bag Tip,EACH,15,15,0,0,2,0.65
8190,Binder Set,EACH,0,0,0,0,2,0.00
8195,Strainer,EACH,0,0,0,0,2,0.00
8205,Water Base Frame,EACH,0,0,0,0,2,103.00
8210,Indoor Banner Cust. Service,EACH,0,0,0,0,2,30.00
8211,A shape Panel,EACH,0,0,0,0,2,35.00
8220,Shelf Liner Cust. Service,EACH,0,0,0,0,2,10.50
8225,Shelf Liner 2 Liner Cust. Service,EACH,0,0,0,0,2,15.00
8304,Rice Warmer,EACH,0,0,0,0,2,220.65
8306,Water Base Attachment,EACH,0,0,0,0,2,29.00
8308,Water Base Frame Bundle Set,EACH,0,0,0,0,2,183.00
8312,Picture Frame  IKEA,EACH,0,0,0,0,2,2.50
8316,A La Carte Sign,EACH,0,0,0,0,2,0.00
8320,Sign Holder CLP,EACH,0,0,0,0,2,1.38
8324,Paper Clock,EACH,9,9,0,0,2,1.50
8335,Static Cling,EACH,-1,-1,0,0,2,7.50
8336,Posters - Hot Food Bundle,EACH,0,0,0,0,2,7.67
8340,Indoor Banner. Fully Cooked,EACH,0,0,0,0,2,30.00
8342,Chef Sp Mini Poster Small,EACH,0,0,0,0,2,1.00
8344,Letter Poster,EACH,0,0,0,0,2,3.00
8345,Ironman Sign & Frames,EACH,0,0,0,0,2,69.00
8346,Poster. Placard Publix,EACH,0,0,0,0,2,4.00
8348,Indoor Banner Stand,EACH,0,0,0,0,2,25.00
8352,Hybrid Program Set,EACH,0,0,0,0,2,0.00
8360,Nutrition Charts. Laminated,EACH,-1,0,1,0,2,3.50
8361,MDB Nutrition Chart,EACH,0,0,0,0,2,3.50
8364,New Color Menu 100,SET,-2,0,2,0,2,14.00
8365,MDB Color Menu 100,EACH,0,0,0,0,2,17.00
8366,Color Menu. Rouses 100 Sh,EACH,0,0,0,0,2,20.00
8368,SAMPLING TAGS,EACH,0,0,0,0,2,9.55
8372,STAR STICKER,EACH,0,0,0,0,2,1.00
8384,Pull up Banner,EACH,0,0,0,0,2,250.00
8500,Curry Kettle Warmer,EACH,0,0,0,0,2,65.00
8504,Sesame Shaker,EACH,13,13,0,0,2,3.42
8508,To Go Soy Cont.,EACH,0,0,0,0,2,2.15
8512,Yosenabe Pot,EACH,-1,0,1,0,2,25.99
8516,Menu Holder,EACH,4,5,1,0,2,27.50
8520,Fish Container Body,EACH,57,57,0,0,2,4.56
8524,Fish Container Top,EACH,50,52,2,0,2,2.73
8528,Food Container (S) Body,EACH,24,24,0,0,2,3.75
8532,Food Cont (S) Lid,EACH,24,24,0,0,2,2.83
8536,Food Cont (L) BD,EACH,30,30,0,0,2,5.36
8540,Food Cont (L) LD,EACH,30,30,0,0,2,3.16
8544,Food Cont (XL) BD,EACH,24,24,0,0,2,7.48
8548,Food Cont (XL) LD,EACH,24,24,0,0,2,4.76
8552,S Rice Box Body,EACH,25,25,0,0,2,12.71
8556,S Rice Box Lid,EACH,25,25,0,0,2,7.83
8560,Rice Mix Box,EACH,13,13,0,0,2,22.14
8564,Rice Mix Box Lid,EACH,25,25,0,0,2,13.00
8568,Rice Bin,EACH,13,13,0,0,2,28.89
8572,Rice Scoop,EACH,6,6,0,0,2,7.95
8576,Rice Spatula,EACH,10,10,0,0,2,3.70
8580,Tong 12in,EACH,0,0,0,0,2,3.85
8584,Measure Cup 1qt,EACH,13,13,0,0,2,7.15
8588,Sauce Bottle,EACH,18,18,0,0,2,0.86
8600,Bluetooth Adapter,EACH,0,0,0,0,2,103.15
8704,Temp Recorder UTRIX-16,EACH,0,0,0,0,2,28.00
8705,PH Tester,EACH,11,11,0,0,2,79.99
8710,PH Replacment Tip,EACH,0,0,0,0,2,40.50
8712,PH Tester Paper,EACH,9,14,5,0,2,11.88
8714,Tablet. Hot Spare,EACH,0,0,0,0,2,489.00
8715,Label Machine,EACH,0,0,0,0,2,740.00
8716,Tablet Bundle 2 TRI,EACH,0,0,0,0,2,748.00
8717,Tablets Bundle 1 TRI,EACH,0,0,0,0,2,984.00
8718,Tablet Outer Case,EACH,0,0,0,0,2,35.00
8719,Zebra Printer LP2824,EACH,0,0,0,0,2,450.00
8720,Scanner,EACH,0,0,0,0,2,388.25
8721,Tablet Bundle 1 WTP,EACH,0,0,0,0,2,798.95
8722,Tablet Bundle 2 WTP,EACH,0,0,0,0,2,365.00
8735,Scan Sheet Single,EACH,0,0,0,0,2,5.00
8740,Scan Sheet Hap Heart,EACH,0,0,0,0,2,3.00
8750,Thermometer  Digital,EACH,7,7,0,0,2,21.50
8755,Rice Cooker,EACH,3,6,3,0,2,143.90
8760,R Cook Inr. Pot,EACH,-5,0,5,0,2,79.60
8765,Rice Cooker Top,EACH,9,9,0,0,2,38.30
8770,Digital Picture Frame,EACH,0,0,0,0,2,150.00
8775,Date Gun,EACH,6,6,0,0,2,67.00
8780,Steamer. Dumpling,EACH,0,0,0,0,2,10.00
8902,HK Happi Coat & Hat,SET,0,0,0,0,2,56.50
8904,Chef Coat White Small,EACH,22,27,5,0,2,20.20
8905,Chef Coat White Medium,EACH,10,11,1,0,2,20.20
8906,Chef Coat White Lg,EACH,16,16,0,0,2,20.20
8907,Chef Coat White XL,EACH,0,0,0,0,2,20.20
8910,Chef Coat Black,EACH,1,1,0,0,2,23.00
8911,Chef Coat. Black.Coastal Pacific,EACH,0,0,0,0,2,26.00
8915,Chef Coat Harris-Teeter,EACH,0,0,0,0,2,32.45
8920,Chef Coat Metropolitan,EACH,0,0,0,0,2,23.00
8925,Chef Coat Red,EACH,12,12,0,0,2,29.30
8930,Chef Coat Yamato,EACH,4,4,0,0,2,34.20
8935,Happi Coat Red Giant Eagle,EACH,0,0,0,0,2,45.00
8940,Chef Coat Rouses,EACH,0,0,0,0,2,25.00
8943,Chef Coat Green Small,EACH,7,8,1,0,2,29.30
8944,Chef Coat Green Medium,EACH,9,9,0,0,2,29.30
8945,Chef Coat Green Large,EACH,10,10,0,0,2,29.30
8950,Polo Shirts White,EACH,11,13,2,0,2,18.00
8954,Apron Black,EACH,31,32,1,0,2,7.75
8958,Hat Black (M),EACH,35,36,1,0,2,5.80
8959,HAT RED DEMO,EACH,12,12,0,0,2,9.00
8962,HOT FOOD BASEBALL CAP,EACH,4,4,0,0,2,5.00
8966,Name Badge,EACH,28,31,3,0,2,2.50
9051,Hat White S.M.L,EACH,-1,0,1,0,2,5.75
9099,Happi White (S),EACH,0,0,0,0,2,17.00
9100,Happi White (M),EACH,0,0,0,0,2,17.00
9101,Happi White (L),EACH,0,0,0,0,2,22.00
9102,Happi White (XL),EACH,0,0,0,0,2,15.50
9103,Happi Hat Whi S,EACH,0,0,0,0,2,0.00
9104,Happi Apron Grn,EACH,0,0,0,0,2,8.50
9107,Happi Hat (M),EACH,0,0,0,0,2,0.00
9108,Happi Hat (L),EACH,0,0,0,0,2,0.00
9109,Happi Blue SMLX,EACH,0,0,0,0,2,0.00
9110,Happi Blue LG,EACH,0,0,0,0,2,17.00
9111,Happi Blue SM,EACH,0,0,0,0,2,17.00
9112,Happi Blue M,EACH,0,0,0,0,2,0.00
9113,Happi Blue XLG,EACH,0,0,0,0,2,17.00
9114,Happi Hat Blue,EACH,0,0,0,0,2,6.00
9117,Happi Gold SML,EACH,0,0,0,0,2,0.00
9118,Happi Gold M,EACH,0,0,0,0,2,21.50
9119,Happi Gold LG,EACH,0,0,0,0,2,21.50
9120,Navy Chef Jacket,EACH,0,0,0,0,2,29.25
9122,Hat Black (S),EACH,0,0,0,0,2,6.00
9124,Hat Black (L),EACH,-1,0,1,0,2,6.00
9125,Happi Gold XSML,EACH,0,0,0,0,2,21.50
9126,Hapi Oishisa SM,EACH,0,0,0,0,2,20.00
9127,Hapi Oishisa M,EACH,0,0,0,0,2,0.00
9128,Hapi Oishisa L,EACH,0,0,0,0,2,20.00
9129,Hapi Oishisa XL,EACH,0,0,0,0,2,20.00
9130,Hapi Wegman SM,EACH,0,0,0,0,2,13.50
9131,Hapi Wegman M,EACH,0,0,0,0,2,13.50
9132,Hapi Wegman L,EACH,0,0,0,0,2,13.50
9133,Hapi Wegman XL,EACH,0,0,0,0,2,13.50
9135,Happi HT M,EACH,0,0,0,0,2,32.00
9136,Happi HT L,EACH,0,0,0,0,2,32.00
9137,Hat HT M,EACH,0,0,0,0,2,7.00
9138,Hat HT L,EACH,0,0,0,0,2,7.00
9139,Happi HT SM,EACH,0,0,0,0,2,13.50
9140,Happi HT XLG,EACH,0,0,0,0,2,32.00
9150,CHEF COAT UNITED,EACH,0,0,0,0,2,29.30
9151,Sweatshirt. Blk,EACH,0,0,0,0,2,17.50
9154,Ninja Apron,EACH,0,0,0,0,2,8.50
9165,Chef Coat Weg,EACH,0,0,0,0,2,20.20
9166,Chef Coat Marsh Black,EACH,0,0,0,0,2,26.00
9171,Chef Coat Fortinos,PK,0,0,0,0,2,20.20
9199,Shelf Molding,EACH,0,0,0,0,2,5.00
9200,Menu Grill Bar,EACH,0,0,0,0,2,0.00
9222,Cap. Steam Table,EACH,0,0,0,0,2,5.00
9223,Apron Steam Table,EACH,0,0,0,0,2,12.00
9224,T-Shirt. Black Steam Table,EACH,0,0,0,0,2,5.00
9225,T-Shirt. Green,EACH,0,0,0,0,2,5.00
9252,Rice Cooker/Warmer 20 cup,EACH,0,0,0,0,2,255.00
9399,Chopstick Color,EACH,0,0,0,0,2,143.90
9400,USB Picture Drive,EACH,0,0,0,0,2,5.79
9440,944 HC Comp Tray,CS,0,0,0,0,2,39.08
9500,Miso Soup Base,CS,0,0,0,0,2,35.96
9799,Sushi Robot SVR-NYA,EACH,0,0,0,0,2,12250.00
9802,Scanner Cable,EACH,0,0,0,0,2,99.00
9803,SCA Pow Supply,EACH,0,0,0,0,2,45.37
9804,PRI Power Supply,EACH,0,0,0,0,2,80.00
9898,Aluminum Mat. Hot FD,EACH,0,0,0,0,2,10.00
9899,Fake Ice Disp Set,EACH,0,0,0,0,2,0.01
9900,U-Boat Utility Cart,EACH,0,0,0,0,2,241.25
9901,Demo Table. Origami,EACH,0,0,0,0,2,120.00
9902,Retractable Banner GO,EACH,0,0,0,0,2,308.00
9913,Price Menu 200,EACH,0,0,0,0,2,5.00
9916,Promotion Poster. Sticker 191167,SET,0,0,0,0,2,23.12
9940,JFC Sushi Tray 0.8 (AFC235)  Set Case,CS,0,0,0,0,2,127.00
9941,JFC Sushi Tray 1.0 (AFC-4) Set Case,CS,0,0,0,0,2,165.00
9942,JFC Sushi Tray 1.5 (AFC-5) Set Case,CS,0,0,0,0,2,147.00
9943,JFC Sushi Tray 2.0 (AFC-30) Set Cs,CS,0,0,0,0,2,132.00
9944,JFC Sushi TraySF27 (AFC-20) Set Cs,CS,0,0,0,0,2,157.00
9950,Waterbase Frame 204245,EACH,0,0,0,0,2,186.00
9951,Waterbase Graphic Panel 195582,EACH,0,0,0,0,2,32.00
9952,Sushi Combo Sticker 203630,EACH,0,0,0,0,2,55.50
9953,$5 Sushi Friday 203347,EACH,0,0,0,0,2,32.50
9954,Customer Appreciation Letter 202797,EACH,0,0,0,0,2,5.54
9955,Deluxe Hot Bowl Sign 204873,EACH,0,0,0,0,2,28.00
9956,Hawaiian Poke Bowl Sign 205409,EACH,0,0,0,0,2,8.91
9958,10% Off Dum W/Card,EACH,0,0,0,0,2,0.90
9959,Sup Bowl. Valen Static Cling 200097,EACH,0,0,0,0,2,24.92
9960,Hot Food Cat Poster 200239,EACH,0,0,0,0,2,6.00
9987,UPC Scan Book Full Set,EACH,0,0,0,0,2,30.00
9992,Disposable Face Mask 50pcs/box,BOX,0,0,0,0,2,25.00
9993,Hair Net for Kitchen,PK,0,0,0,0,2,31.00
9994,Sanitizer for Kitchen,EACH,0,0,0,0,2,10.00
9995,Dish Soap for Kitchen,EACH,0,0,0,0,2,4.50
9997,SHIPPING & HANDLING,EACH,0,0,0,0,2,6.00
9998,WT Invoice No Tax,EACH,0,0,0,0,2,13.00
9999,15% OFF STICKERS,EACH,0,0,0,0,2,3.00
